一	m
乙	nu
二	mm
十	j
丁	mn
厂	mh
七	ju
卜	y
八	ho
人	o
入	oh
儿	lu
匕	uh
几	hn
九	kn
刁	sm
了	nn
刀	sh
力	ks
乃	nhs
又	nk
三	mmm
干	mj
于	md
亏	mmvs
工	mlm
土	g
士	jm
才	dh
下	my
寸	di
大	k
丈	jk
与	ysm
万	ms
上	ym
小	nc
口	r
山	u
巾	lb
千	hj
乞	on
川	lll
亿	on
个	ol
夕	ni
久	no
么	hi
勺	pm
凡	hni
丸	kni
及	nhe
广	yh
亡	yv
门	lis
丫	cl
义	ik
之	ino
尸	s
己	su
已	su
巳	ru
弓	n
子	nd
卫	slm
也	pd
女	v
刃	shi
飞	no
习	sim
叉	ei
马	nvsm
乡	vvh
丰	qj
王	mg
开	mt
井	tt
天	mk
夫	qo
元	mmu
无	mku
云	mmi
专	qni
丐	myvs
扎	qu
艺	tn
木	d
五	mdm
支	je
厅	mmn
不	mf
犬	ik
太	ki
区	sk
历	mks
歹	mni
友	ke
尤	iku
匹	sc
车	kq
巨	ss
牙	mvdh
屯	pu
戈	i
比	pp
互	mvnm
切	psh
瓦	mvni
止	ylm
少	fh
曰	a
日	a
中	l
贝	bo
冈	bk
内	ob
水	e
见	bhu
午	oj
牛	hq
手	q
气	omn
毛	hqu
壬	hg
升	ht
夭	hk
长	po
仁	omm
什	oj
片	llml
仆	oy
化	op
仇	okn
币	hlb
仍	onhs
仅	oe
斤	hml
爪	hlo
反	he
介	oll
父	ck
从	oo
仑	op
今	oin
凶	uk
分	csh
乏	hino
公	ci
仓	osu
月	b
氏	hvp
勿	phh
欠	no
风	hnk
丹	by
匀	pim
乌	pvsm
勾	pi
凤	hne
六	yc
文	yk
亢	yhn
方	yhs
火	f
为	iksi
斗	yj
忆	pn
计	ivj
订	ivmn
户	is
认	ivo
冗	bhn
讥	ivhn
心	p
尺	so
引	nl
丑	ng
巴	au
孔	ndu
队	nlo
办	ksc
以	vio
允	ihu
予	ninn
邓	enl
劝	eks
双	ee
书	ids
幻	vis
玉	mgi
刊	mjln
未	jd
末	dj
示	mmf
击	qu
打	qmn
巧	mmvs
正	mylm
扑	qy
卉	jt
扒	qc
功	mks
扔	qnhs
去	gi
甘	tm
世	pt
艾	tk
古	jr
节	tsl
本	dm
术	id
可	mnr
丙	mob
左	km
厉	mms
石	mr
右	kr
布	klb
夯	kks
戊	ih
龙	ikp
平	mfj
灭	mf
轧	kqu
东	kd
卡	ymy
北	lmp
占	yr
凸	bss
卢	ys
业	tc
旧	la
帅	lllb
归	llsm
旦	am
目	bu
且	bm
叶	rj
甲	wl
申	lwl
叮	rmn
电	lwu
号	rmvs
田	w
由	lw
只	rc
叭	rc
史	lk
央	lbk
兄	rhu
叽	rhn
叼	rsm
叫	rvl
叩	rsl
叨	rsh
另	rks
叹	re
冉	gb
皿	bt
凹	ssu
囚	wo
四	wc
生	hqm
矢	ok
失	hqo
乍	os
禾	hd
丘	om
付	odi
仗	ojk
代	oip
仙	ou
们	olis
仪	oik
白	ha
仔	ond
他	opd
斥	hmy
瓜	hvio
乎	hfd
丛	oom
令	oini
用	bq
甩	bqu
印	hpsl
尔	nf
乐	hvd
句	pr
匆	pkk
册	bbm
卯	hhsl
犯	khsu
外	niy
处	heo
冬	hey
鸟	pysm
务	heks
包	pru
饥	nvhn
主	yg
市	ylb
立	yt
冯	imnvm
玄	yvi
闪	lso
兰	tmm
半	fq
汁	ej
汇	es
头	yk
汉	ee
宁	jmn
穴	jc
它	jp
讨	ivdi
写	bysm
让	ivym
礼	ifu
训	ivlll
议	ivik
必	ph
讯	ivnj
记	ivsu
永	ine
司	smr
尼	sp
民	rvp
弗	lln
弘	ni
出	uu
辽	ynn
奶	vnhs
奴	ve
召	shr
加	ksr
皮	dhe
边	yks
孕	nsnd
发	ivke
圣	eg
对	edi
台	ir
矛	ninh
纠	vmvl
母	wyi
幼	viks
丝	vvm
邦	qjnl
式	ipm
迂	ymd
刑	mtln
戎	ij
动	miks
扛	qm
寺	gdi
吉	gr
扣	qr
考	jkys
托	qhp
老	jkp
巩	mhni
圾	gnhe
执	qkni
扩	qi
扫	qsm
地	gpd
场	gnsh
扬	qnsh
耳	sj
芋	tmd
共	tc
芒	tyv
亚	mtc
芝	tino
朽	dmvs
朴	dy
机	dhn
权	de
过	ydi
臣	slsl
吏	jlk
再	mgb
协	jksc
西	mcw
压	mgi
厌	mik
戌	ihm
在	klg
百	ma
有	kb
存	klnd
而	mbll
页	mbo
匠	shml
夸	kmms
夺	kdi
灰	kf
达	yk
列	mnln
死	mnp
成	ihs
夹	kt
夷	kn
轨	kqkn
邪	mhnl
尧	jpmu
划	iln
迈	yms
毕	ppj
至	mig
此	ymp
贞	ybo
师	llmb
尘	fg
尖	fk
劣	fhks
光	fmu
当	fsm
早	aj
吁	rmd
吐	rg
吓	rmy
虫	lmi
曲	tw
团	wdh
吕	rr
同	bmr
吊	rlb
吃	ron
因	wk
吸	rnhe
吗	rnvm
吆	rvi
屿	uysm
屹	uon
岁	uni
帆	lbhni
回	wr
岂	usu
则	boln
刚	bkln
网	bkk
肉	obo
年	oq
朱	hjd
先	hghu
丢	hgi
廷	nkhg
舌	hjr
竹	h
迁	yhj
乔	hkll
迄	yon
伟	oqs
传	oqni
乒	omh
乓	omi
休	od
伍	omdm
伏	oik
优	oiku
臼	hx
伐	oi
延	nkhym
仲	ol
件	ohq
任	ohg
伤	ooks
价	ooll
伦	oop
份	ocsh
华	opj
仰	ohvl
仿	oyhs
伙	of
伪	oiks
自	hbu
伊	osk
血	hbt
向	hbr
似	ovio
后	hmr
行	hommn
舟	hbyi
全	omg
会	ommi
杀	kd
合	omr
兆	lmuo
企	oylm
众	ooo
爷	cksl
伞	ofj
创	ouln
肌	bhn
肋	bks
朵	hnd
杂	knd
危	nmsu
旬	pa
旨	pa
旭	kna
负	nbo
匈	puk
名	nir
各	her
多	nini
争	nsd
色	nau
壮	lmg
冲	iml
妆	lmv
冰	ime
庄	ig
庆	ik
亦	ylnc
刘	ykln
齐	ykll
交	yck
衣	yhv
次	mmno
产	yth
决	imdk
亥	yvho
充	yihu
妄	yvv
闭	lsdh
问	lsr
闯	lsnvm
羊	tq
并	tt
关	tk
米	fd
灯	fmn
州	ilil
汗	emj
污	emms
江	em
汛	enj
池	epd
汝	ev
汤	ensh
忙	pyv
兴	fmc
宇	jmd
守	jdi
宅	jhp
字	jnd
安	jv
讲	ivtt
讳	ivqs
军	bkq
讶	ivmvh
许	ivoj
讹	ivop
论	ivop
讼	ivci
农	hbv
讽	ivhnk
设	ivhne
访	ivyhs
诀	ivdk
寻	smdi
那	sqnl
迅	ynj
尽	soy
导	rudi
异	sut
弛	npd
孙	ndf
阵	nlkq
阳	nla
收	vlok
阶	nloll
阴	nlb
防	nlyhs
奸	vmj
如	vr
妇	vsm
妃	vsu
好	vnd
她	vpd
妈	vnvm
戏	ei
羽	smsim
观	ebhu
欢	eno
买	nyk
红	vmm
驮	nmk
纤	vmhj
驯	nmlll
约	vmpi
级	vmnhe
纪	vmsu
驰	nmpd
纫	vmshi
巡	yvvv
寿	qkdi
弄	mgt
麦	qme
玖	mgno
玛	mgnvm
形	mthhh
进	ytt
戒	it
吞	mkr
远	ymmu
违	yqs
韧	qsshi
运	ymmi
扶	qqo
抚	qmku
坛	gmmi
技	qje
坏	gmf
抠	qsk
扰	qiku
扼	qmsu
拒	qss
找	qi
批	qpp
址	gylm
扯	qylm
走	gyo
抄	qfh
贡	mbo
汞	me
坝	gbo
攻	mok
赤	glnc
折	qhml
抓	qhlo
扳	qhe
抡	qop
扮	qcsh
抢	qosu
孝	jknd
坎	gno
均	gpmm
抑	qhvl
抛	qkns
投	qhne
坟	gyk
坑	gyhn
抗	qyhn
坊	gyhs
抖	qyj
护	qis
壳	gbhn
志	gp
块	gdk
扭	qng
声	gah
把	qau
报	qsle
拟	qvio
却	gisl
抒	qnin
劫	giks
芙	tqo
芜	tmku
苇	tqs
芽	tmvh
花	top
芹	thml
芥	toll
芬	tcsh
苍	tosu
芳	tyhs
严	mtch
芦	ths
芯	tp
劳	tbks
克	jrhu
芭	tau
苏	tksc
杆	dmj
杠	dm
杜	dg
材	ddh
村	ddi
杖	djk
杏	dr
杉	dhhh
巫	moo
极	dnhe
李	dnd
杨	dnsh
求	ije
甫	ijb
匣	swl
更	mlwk
束	dl
吾	mmr
豆	mrt
两	moob
酉	mcwm
丽	mmbib
医	sok
辰	mmmv
励	msks
否	mfr
还	ymf
尬	kuoll
歼	mnhj
来	dt
连	ykq
轩	kqmj
步	ylmh
卤	ywk
坚	leg
肖	fb
旱	amj
盯	bumn
呈	rhg
时	adi
吴	rmk
助	bmks
县	bmi
里	wg
呆	rd
吱	rje
吠	rik
呕	rsk
园	wmmu
旷	ai
围	wqs
呀	rmvh
吨	rpu
足	ryo
邮	lwnl
男	wks
困	wd
吵	rfh
串	ll
员	rbo
呐	rob
听	rhml
吟	roin
吩	rcsh
呛	rosu
吻	rphh
吹	rno
呜	rpvm
吭	ryhn
吧	rau
邑	rau
吼	rndu
囤	wpu
别	rsln
吮	rihu
岖	usk
岗	ubk
帐	lbpo
财	bodh
针	opj
钉	opmn
牡	hqg
告	hgr
我	hqi
乱	hru
利	hdln
秃	hdhn
秀	hdnhs
私	hdi
每	owyi
兵	omc
估	ojr
体	odm
何	omnr
佐	okm
佑	okr
但	oam
伸	olwl
佃	ow
作	oos
伯	oha
伶	ooii
佣	obq
低	ohpm
你	onf
住	oyg
位	oyt
伴	ofq
身	hxh
皂	hap
伺	osmr
佛	olln
囱	hwni
近	yhml
彻	hopsh
役	hohne
返	yhe
余	omd
希	kklb
坐	oog
谷	cor
妥	bv
含	oinr
邻	oinl
岔	cshu
肝	bmj
肛	bm
肚	bg
肘	bdi
肠	bnsh
龟	nwu
甸	pw
免	nahu
狂	khmg
犹	khiku
狈	khbo
角	nbg
删	bmln
条	hed
彤	byhhh
卵	hhsli
灸	nof
岛	pysu
刨	puln
迎	yhvl
饭	nvhe
饮	nvno
系	hvif
言	ymmr
冻	imkd
状	lmik
亩	yw
况	imrhu
床	id
库	ikq
庇	ipp
疗	knn
吝	ykr
应	ifm
这	yyk
冷	imoii
庐	ihs
序	inin
辛	ytj
弃	yit
冶	imir
忘	yvp
闰	lsmg
闲	lsd
间	lsa
闷	lsp
判	fqln
兑	crhu
灶	fg
灿	fu
灼	fpm
弟	cnlh
汪	emg
沐	ed
沛	eylb
汰	eki
沥	emks
沙	efh
汽	eomn
沃	ehk
沦	eop
汹	euk
泛	ehio
沧	eosu
没	ehne
沟	epi
沪	ehs
沈	elbu
沉	ebhu
沁	ep
怀	pmf
忧	piku
忱	plbu
快	pdk
完	jmmu
宋	jd
宏	jki
牢	jhq
究	jckn
穷	jcks
灾	jf
良	iav
证	ivmym
启	hsr
评	ivmfj
补	ly
初	lsh
社	ifg
祀	ifru
识	ivrc
诈	ivos
诉	ivhmy
罕	bcmj
诊	ivohh
词	ivsmr
译	iveq
君	skr
灵	smf
即	aisl
层	smmi
屁	spp
尿	se
尾	shqu
迟	yso
局	ssr
改	suok
张	npo
忌	sup
际	nlmmf
陆	nlqu
阿	nlmnr
陈	nlkd
阻	nlbm
附	nlodi
坠	nog
妓	vje
妙	vfh
妖	vhk
姊	vlxh
妨	vyhs
妒	vhs
努	veks
忍	sip
劲	nmks
矣	iok
鸡	epym
纬	vmqs
驱	nmsk
纯	vmpu
纱	vmfh
纲	vmbk
纳	vmob
驳	nmkk
纵	vmoo
纷	vmcsh
纸	vmhvp
纹	vmyk
纺	vmyhs
驴	nmis
纽	vmng
奉	qkq
玩	mgmmu
环	mgmf
武	mpylm
青	qmb
责	qmbo
现	mgbhu
玫	mgok
表	qmv
规	qobhu
抹	qdj
卦	ggy
坷	gmnr
坯	gmfm
拓	qmr
拢	qikp
拔	qikk
坪	gmfj
拣	qkvc
坦	gam
担	qam
坤	glwl
押	qwl
抽	qlw
拐	qrsh
拖	qopd
者	jka
拍	qha
顶	mnmbo
拆	qhmy
拎	qoii
拥	qbq
抵	qhpm
拘	qpr
势	qiks
抱	qpru
拄	qyg
垃	gyt
拉	qyt
拦	qtmm
幸	gtj
拌	qfq
拧	qjmn
拂	qlln
拙	quu
招	qshr
坡	gdhe
披	qdhe
拨	qive
择	qeq
抬	qir
拇	qwyi
拗	qvis
其	tmmc
取	sje
茉	tdj
苦	tjr
昔	ta
苛	tmnr
若	tkr
茂	tih
苹	tmfj
苗	tw
英	tlbk
苟	tpr
苑	tniu
苞	tpru
范	tesu
直	jbmm
茁	tuu
茄	tksr
茎	tnom
苔	tir
茅	tnih
枉	dmg
林	dd
枝	dje
杯	dmf
枢	dsk
柜	dss
枚	dok
析	dhml
板	dhe
松	dci
枪	dosu
枫	dhnk
构	dpi
杭	dyhn
杰	df
述	yijc
枕	dlbu
丧	gcv
或	irm
画	muw
卧	sly
事	jlln
刺	dbln
枣	dby
雨	mlby
卖	jnyk
郁	kbnl
矾	mrhni
矿	mri
码	mrnvm
厕	mbon
奈	kmmf
奔	kjt
奇	kmnr
奋	kw
态	kip
欧	skno
殴	skhne
垄	ipg
妻	jlv
轰	kqee
顷	pmbo
转	kqqni
斩	kqhml
轮	kqop
软	kqno
到	mgln
非	lmsy
叔	yfe
歧	ymje
肯	ymb
齿	ymuo
些	ypmm
卓	yaj
虎	yphu
虏	ypks
肾	leb
贤	lebo
尚	fbr
旺	amg
具	bmmc
味	rjd
果	wd
昆	app
国	wmgi
哎	rtk
咕	rjr
昌	aa
呵	rmnr
畅	llnsh
明	ab
易	aphh
咙	rikp
昂	ahvl
迪	ylw
典	tbc
固	wjr
忠	lp
呻	rlwl
咒	rrhn
咋	ros
咐	rodi
呼	rhfd
鸣	rpym
咏	rine
呢	rsp
咄	ruu
咖	rksr
岸	ummj
岩	umr
帖	lbyr
罗	wlni
帜	lbrc
帕	lbha
岭	uoii
凯	uuhn
败	book
账	bopo
贩	bohe
贬	bohio
购	bopi
贮	bojm
图	whey
钓	oppi
制	hbln
知	okr
迭	yhqo
氛	oncsh
垂	hjtm
牧	hqok
物	hqphh
乖	hjlp
刮	hrln
秆	hdmj
和	hdr
季	hdnd
委	hdv
秉	hdl
佳	ogg
侍	ogdi
岳	omu
供	otc
使	ojlk
例	omnn
侠	okt
侥	ojpu
版	llhe
侄	omig
侦	oybo
侣	orr
侧	obon
凭	oghn
侨	ohkl
佩	ohnb
货	opbo
侈	onin
依	oyhv
卑	hwhj
的	hapi
迫	yha
质	hjbo
欣	hlno
征	homym
往	hoyg
爬	hoau
彼	hodhe
径	honom
所	hshml
舍	omjr
金	c
刹	kdln
命	omrl
肴	kkb
斧	ckhml
爸	ckau
采	bd
觅	bbhu
受	bbe
乳	bdu
贪	oino
念	oinp
贫	csho
忿	cshp
肤	bqo
肺	bylb
肢	bje
肿	bl
胀	bpo
朋	bb
股	bhne
肮	byhn
肪	byhs
肥	bau
服	bsle
胁	bksc
周	bgr
昏	hpa
鱼	nwm
兔	nahi
狐	khhvo
忽	php
狗	khpr
狞	khjmn
备	hew
饰	nvolb
饱	nvpru
饲	nvsmr
变	yce
京	yrf
享	yrnd
庞	iikp
店	iyr
夜	yonk
庙	ilw
府	iodi
底	ihpm
疟	ksm
疙	kon
疚	kno
剂	ylln
卒	yooj
郊	yknl
庚	ilo
废	iive
净	imnsd
盲	yvbu
放	ysok
刻	yoln
育	yib
氓	yvrvp
闸	lswl
闹	lsylb
郑	tknl
券	fqsh
卷	fqsu
单	cwj
炬	fss
炒	ffh
炊	fno
炕	fyhn
炎	ff
炉	fhs
沫	edj
浅	eij
法	egi
泄	ept
沽	ejr
河	emnr
沾	eyr
泪	ebu
沮	ebm
油	elw
泊	eha
沿	ecr
泡	epru
注	eyg
泣	eyt
泞	ejmn
泻	ebym
泌	eph
泳	eine
泥	esp
沸	elln
沼	eshr
波	edhe
泼	eive
泽	eeq
治	eir
怔	pmym
怯	pgi
怖	pklb
性	phqm
怕	pha
怜	poii
怪	peg
怡	pir
学	fbnd
宝	jmgi
宗	jmmf
定	jmyo
宠	jikp
宜	jbm
审	jlwl
宙	jlw
官	jrlr
空	jcm
帘	jclb
宛	jniu
实	jyk
试	ivipm
郎	iinl
诗	ivgdi
肩	hsb
房	hsyhs
诚	ivihs
衬	ldi
衫	lhhh
视	ifbhu
祈	ifhml
话	ivhjr
诞	ivnkv
诡	ivnmu
询	ivpa
该	ivyvo
详	ivtq
建	nklq
肃	llfl
录	nmme
隶	le
帚	smblb
屉	spt
居	sjr
届	slw
刷	sbln
屈	suu
弧	nhvo
弥	nnf
弦	nyvi
承	nnqo
孟	ndbt
陋	nlmbv
陌	nlma
孤	ndhvo
陕	nlkt
降	nlheq
函	une
限	nlav
妹	vjd
姑	vjr
姐	vbm
姓	vhqm
妮	vsp
始	vir
姆	vwyi
迢	yshr
驾	krnvm
叁	ikmmm
参	ikhhh
艰	eav
线	vmij
练	vmkvc
组	vmbm
绅	vmlwl
细	vmw
驶	nmlk
织	vmrc
驹	nmpr
终	vmhey
驻	nmyg
绊	vmfq
驼	nmjp
绍	vmshr
绎	vmeq
经	vmnom
贯	wjbo
契	qhk
贰	ipmmo
奏	qkhk
春	qka
帮	qllb
玷	mgyr
珍	mgohh
玲	mgoii
珊	mgbt
玻	mgdhe
毒	qmwyi
型	mng
拭	qipm
挂	qgg
封	ggdi
持	qgdi
拷	qjks
拱	qtc
项	mmbo
垮	gkms
挎	qkms
城	gihs
挟	qkt
挠	qjpu
政	mmok
赴	goy
赵	gok
挡	qfsm
拽	qlwp
哉	jir
挺	qnkg
括	qhjr
垢	ghmr
拴	qomg
拾	qomr
挑	qlmo
垛	ghnd
指	qpa
垫	qig
挣	qnsd
挤	qykl
拼	qyjj
挖	qjcn
按	qjv
挥	qbkq
挪	qsql
拯	qnem
某	tmd
甚	tmmv
荆	tjln
茸	tsj
革	tlj
茬	tklg
荐	tkld
巷	tcru
带	tjblb
草	taj
茧	tlmi
茵	twk
茶	tod
荒	tyvu
茫	teyv
荡	tenh
荣	tbd
荤	tbkq
荧	tbf
故	jrok
胡	jrb
荫	tnlb
荔	tkss
南	jbtj
药	tvmi
标	dmmf
栈	dij
柑	dtm
枯	djr
柄	dmob
栋	dkd
相	dbu
查	dam
柏	dha
栅	dbbm
柳	dhhl
柱	dyg
柿	dylb
栏	dtmm
柠	djmn
树	dedi
勃	jdks
要	mwv
柬	dwf
咸	ihmr
威	ihmv
歪	mfmym
研	mrmt
砖	mrqni
厘	mwg
厚	mand
砌	mrpsh
砂	mrfh
泵	mre
砚	mrbhu
砍	mrno
面	mwsl
耐	mbdi
耍	mbv
牵	kbhq
鸥	skpym
残	mnij
殃	mnlbk
轴	kqlw
轻	kqnom
鸦	mhpym
皆	ppha
韭	lsmm
背	lpb
战	yri
点	yrf
虐	ypsm
临	lloa
览	libhu
竖	leyt
省	fhbu
削	fbln
尝	fbmmi
昧	ajd
盹	bupu
是	amyo
盼	bucsh
眨	buhio
哇	rgg
哄	rtc
哑	rmtc
显	atc
冒	abu
映	albk
星	ahqm
昨	aos
咧	rmnn
昭	ashr
畏	wmv
趴	rmc
胃	wb
贵	lmbo
界	woll
虹	lim
虾	limy
蚁	liik
思	wp
蚂	linvm
虽	rlmi
品	rrr
咽	rwk
骂	rrnvm
勋	roks
哗	ropj
咱	rhbu
响	rhbr
哈	romr
哆	rnin
咬	ryck
咳	ryvo
咪	rfd
哪	rsql
哟	rvmi
炭	umf
峡	ukt
罚	wlivn
贱	boij
贴	boyr
贻	boir
骨	bbb
幽	uvii
钙	opmys
钝	oppu
钞	opfh
钟	opl
钢	opbk
钠	opob
钥	opb
钦	opno
钧	oppim
钩	oppi
钮	opng
卸	omsl
缸	oum
拜	hqmqj
看	hqbu
矩	okss
毡	huyr
氢	onnom
怎	osp
牲	hqhqm
选	yhgu
适	yhjr
秒	hdfh
香	hda
种	hdl
秋	hdf
科	hdyj
重	hjwg
复	oahe
竿	hmj
段	hjhne
便	omlk
俩	omob
贷	opbo
顺	lllo
修	oloh
俏	ofb
保	ord
促	oryo
俄	ohqi
俐	ohdn
侮	oowy
俭	oomm
俗	ocor
俘	obnd
信	oymr
皇	hamg
泉	hae
鬼	hui
侵	osme
禹	hlbi
侯	onmk
追	yhrr
俊	oice
盾	hjbu
待	hogdi
徊	howr
衍	hoemn
律	holq
很	hoav
须	hhmbo
叙	ode
剑	omln
逃	ylmo
食	oiav
盆	csht
胚	bmfm
胧	bikp
胆	bam
胜	bhqm
胞	bpru
胖	bfq
脉	bine
胎	bir
勉	nuks
狭	khkt
狮	khllb
独	khlmi
狰	khnsd
狡	khyck
狱	khivk
狠	khav
贸	hhbo
怨	nup
急	nmp
饵	nvsj
饶	nvjpu
蚀	nvlmi
饺	nvyck
饼	nvtt
峦	ycu
弯	ycn
将	lmnii
奖	lnk
哀	yrhv
亭	yrbn
亮	yrbu
度	ite
迹	yylc
庭	inkg
疮	kosu
疯	khnk
疫	khne
疤	kau
咨	mor
姿	mov
亲	ytd
音	yta
帝	yblb
施	ysopd
闺	lsgg
闻	lssj
闽	lslmi
阀	lsoi
阁	lsher
差	tqm
养	toll
美	tgk
姜	tgv
叛	fqhe
送	ytk
类	fdk
迷	yfd
籽	fdnd
娄	fdv
前	tbln
首	thbu
逆	ytu
兹	tvii
总	crp
炼	fkvc
炸	fos
烁	fhvd
炮	fpru
炫	fyvi
烂	ftmm
剃	chln
洼	egg
洁	egr
洪	etc
洒	emcw
柒	epd
浇	ejpu
浊	elmi
洞	ebmr
测	ebon
洗	ehgu
活	ehjr
派	ehhv
洽	eomr
染	end
洛	eher
浏	eykn
济	eykl
洋	etq
洲	eill
浑	ebkq
浓	ehbv
津	elq
恃	pgdi
恒	pmam
恢	pkf
恍	pfmu
恬	phjr
恤	phbt
恰	pomr
恼	pyuk
恨	pav
举	fcq
觉	fbbhu
宣	jmam
宦	jsll
室	jmig
宫	jrr
宪	jhgu
突	jcik
穿	jcmvh
窃	jcpsh
客	jher
诫	ivit
冠	bmui
诬	ivmoo
语	ivmmr
扁	hsbt
袄	lhk
祖	ifbm
神	iflwl
祝	ifrhu
祠	ifsmr
误	ivrmk
诱	ivhds
诲	ivowy
说	ivcru
诵	ivnib
垦	avg
退	yav
既	aimvu
屋	smig
昼	soam
屏	stt
屎	sfd
费	lnbo
陡	nlgyo
逊	yndf
眉	ahbu
孩	ndyvo
陨	nlrbo
除	nlomd
险	nlomm
院	nljmu
娃	vgg
姥	vjkp
姨	vkn
姻	vwk
娇	vhkl
姚	vlmo
娜	vsql
怒	vep
架	krd
贺	krbo
盈	nsbt
勇	nbks
怠	irp
癸	nomk
蚤	eilmi
柔	nhd
垒	iiig
绑	vmqjl
绒	vmij
结	vmgr
绕	vmjpu
骄	nmhkl
绘	vmomi
给	vmomr
绚	vmpa
骆	nmher
络	vmher
绝	vmnau
绞	vmyck
骇	nmyvo
统	vmyiu
耕	qdtt
耘	qdmmi
耗	qdhqu
耙	qdau
艳	qjnau
泰	qke
秦	qkhd
珠	mghjd
班	mgilg
素	qmvif
匿	stkr
蚕	hklmi
蚕	mklmi
顽	mumbo
盏	ijbt
匪	slmy
捞	qtbs
栽	jid
捕	qijb
埂	gmlk
捂	qmmr
振	qmmv
载	jikq
赶	gomj
起	goru
盐	gybt
捎	qfb
捍	qamj
捏	qag
捏	qhxg
埋	gwg
捉	qryo
捆	qwd
捐	qrb
损	qrbo
袁	grhv
捌	qrsn
都	janl
哲	qlr
逝	yqhl
捡	qomm
挫	qoog
换	qnbk
挽	qnau
挚	qiq
热	qif
恐	mnp
捣	qpyu
壶	gbtc
捅	qnib
埃	giok
挨	qiok
耻	sjylm
耿	sjf
耽	sjlbu
聂	sjee
恭	tcp
莽	tikt
莱	tdt
莲	tykq
莫	tak
莉	thdn
荷	tomr
获	tkhk
晋	mca
恶	mcp
莹	tbmi
莺	tbpm
真	jbmc
框	dsmg
梆	dqjl
桂	dgg
桔	dgr
栖	dmcw
档	dfsm
桐	dbmr
株	dhjd
桥	dhkl
桦	dopj
栓	domg
桃	dlmo
格	dher
桩	dig
校	dyck
核	dyvo
样	dtq
根	dav
索	jbvif
哥	mrnr
速	ydl
逗	ymrt
栗	mwd
贾	mwbo
酌	mwpm
配	mwsu
翅	jesmm
辱	mvdi
唇	mvr
夏	muhe
砸	mrslb
砰	mrmfj
砾	mrhvd
础	mruu
破	mrdhe
原	mhaf
套	ksmi
逐	ymso
烈	mnf
殊	mnhjd
殉	mnpa
顾	mumbo
轿	kqhkl
较	kqyck
顿	pumbo
毙	ppmnp
致	mgok
柴	ypd
桌	yad
虑	ypp
监	libt
紧	levif
党	fbrhu
逞	yrhg
晒	amcw
眠	burvp
晓	ajpu
哮	rjkd
唠	rtbs
鸭	wlpym
晃	afmu
哺	rijb
晌	ahbr
剔	ahln
晕	abkq
蚌	liqj
畔	wfq
蚣	lici
蚊	liyk
蚪	liyj
蚓	linl
哨	rfb
哩	rwg
圃	wijb
哭	rrik
哦	rhqi
恩	wkp
鸯	lkpym
唤	rnbk
唁	rymr
哼	ryrn
唧	rail
啊	rnlr
唉	riok
唆	rice
罢	wlgi
峭	ufb
峨	uhqi
峰	uhej
圆	wrbo
峻	uice
贼	boij
贿	bokb
赂	boher
赃	boig
钱	opij
钳	optm
钻	opyr
钾	opwl
铁	ophqo
铃	opoii
铅	ophnr
缺	oudk
氧	ontq
氨	onjv
特	hqgdi
牺	hqmcw
造	yhgr
乘	hdlp
敌	hrok
秤	hdmfj
租	hdbm
积	hdrc
秧	hdlbk
秩	hdhqo
称	hdnf
秘	hdph
透	yhds
笔	hhqu
笑	hhk
笋	hsk
债	oqmo
借	ota
值	ojbm
倚	okmr
俺	oklu
倾	opmo
倒	omgn
倘	ofbr
俱	obmc
倡	oaa
候	olnk
赁	ogbo
俯	oioi
倍	oytr
倦	ofqu
健	onkq
臭	huik
射	hhdi
躬	hhn
息	hup
倔	osuu
徒	hogyo
徐	hoomd
殷	hshne
舰	hybhu
舱	hyosu
般	hyhne
航	hyyhn
途	yomd
拿	orq
耸	oosj
爹	cknin
舀	bhx
爱	bbke
豺	bhdh
豹	bhpi
颁	chmbo
颂	cimbo
翁	cism
胰	bkn
脆	bnmu
脂	bpa
胸	bpuk
胳	bher
脏	big
脐	bykl
胶	byck
脑	byuk
脓	bhbv
逛	ykhg
狸	khwg
狼	khiav
卿	hhail
逢	yhej
鸵	pmjp
留	hhw
鸳	nupym
皱	nsdhe
饿	nvhqi
馁	nvbv
凌	imgce
凄	imjlv
恋	ycp
桨	lnd
浆	lne
衰	ywmv
衷	jlhv
高	yrbr
郭	ydnl
席	itlb
准	imog
座	ioog
症	kmym
病	kmob
疾	kok
斋	ykmbl
疹	kohh
疼	khey
疲	kdhe
脊	fcb
效	ykok
离	yukb
紊	ykvif
唐	ilr
瓷	momvn
资	iobo
凉	imyrf
站	ytyr
剖	yrln
竞	ytrhu
部	yrnl
旁	ybyhs
旅	ysohv
畜	yviw
阅	lscru
羞	tqng
羔	tgf
瓶	ttmvn
拳	fqq
粉	fdcsh
料	fdyj
益	tcbt
兼	txc
烤	fjks
烘	ftc
烦	fmbo
烧	fjpu
烛	flmi
烟	fwk
烙	fher
递	ycnh
涛	eqki
浙	eqhl
涝	etbs
浦	eijb
酒	emcw
涉	eylh
消	efb
涡	erob
浩	ehgr
海	eowy
涂	eomd
浴	ecor
浮	ebnd
涣	enbk
涤	ehed
流	eyiu
润	elsg
涧	elsa
涕	ecnh
浪	eiav
浸	esme
涨	enpo
烫	ehf
涩	esim
涌	enib
悖	pjbd
悟	pmmr
悄	pfb
悍	pamj
悔	powy
悯	plsk
悦	pcru
害	jqmr
宽	jtbu
家	jmso
宵	jfb
宴	jav
宾	jomc
窍	jcmms
窄	jcos
容	jcor
宰	jytj
案	jvd
请	ivqmb
朗	iib
诸	ivjka
诺	ivtkr
读	ivjnk
扇	hssmm
诽	ivlmy
袜	ldj
袖	llw
袍	lpru
被	ldhe
祥	iftq
课	ivwd
冥	bayc
谁	ivog
调	ivbgr
冤	bnai
谅	ivyrf
谆	ivyrd
谈	ivff
谊	ivjbm
剥	neln
恳	avp
展	stv
剧	srln
屑	sfb
弱	nmnim
陵	nlgce
祟	uummf
陶	nlpou
陷	nlnhx
陪	nlytr
娱	vrmk
娟	vrb
恕	vrp
娥	vhqi
娘	viav
通	ynib
能	ibpp
难	eog
预	nnmbo
桑	eeed
绢	vmrb
绣	vmhds
验	nmomm
继	vmvfd
骏	nmice
球	mgije
琐	mgfbo
理	mgwg
琉	mgyiu
琅	mgiav
捧	qqkq
堵	gjka
措	qta
描	qtw
域	girm
捺	qkmf
掩	qklu
捷	qjlo
排	qlmy
焉	mylf
掉	qyaj
捶	qhjm
赦	gcok
堆	gog
推	qog
埠	ghrj
掀	qhlo
授	qbbe
捻	qoip
教	jdok
掏	qpou
掐	qnhx
掠	qyrf
掂	qiyr
培	gytr
接	qytv
掷	qtkl
控	qjcm
探	qbcd
据	qsjr
掘	qsuu
掺	qikh
职	sjrc
基	tcg
聆	sjoii
勘	tvks
聊	sjhhl
娶	sev
著	tjka
菱	tgce
勒	tjks
黄	tlwc
菲	tlmy
萌	tab
萝	twln
菌	twhd
萎	thdv
菜	tbd
萄	tpou
菊	tpfd
菩	tytr
萍	temj
菠	tede
萤	tbli
营	tbrr
乾	jjon
萧	tlll
萨	tnlh
菇	tvjr
械	dit
彬	ddhh
梦	ddni
婪	ddv
梗	dmlk
梧	dmmr
梢	dfb
梅	dowy
检	domm
梳	dyiu
梯	dcnh
桶	dnib
梭	dice
救	ieok
曹	twa
副	mwln
票	mwmmf
酝	mwmmi
酗	mwuk
厢	mdbu
戚	ihymf
硅	mrgg
硕	mrmbo
奢	kjka
盔	kfbt
爽	kkkk
聋	ipsj
袭	ipyhv
盛	isbt
匾	shsb
雪	mbsm
辅	kqijb
辆	kqmob
颅	ysmbo
虚	yptc
彪	yuhhh
雀	fog
堂	fbrg
常	fbrlb
眶	busmg
匙	aop
晨	ammv
睁	bunsd
眯	bufd
眼	buav
悬	bip
野	wgnin
啪	rqha
啦	rqyt
曼	awle
晦	aowy
晚	anau
啄	rmso
啡	rlmy
距	rmss
趾	rmylm
啃	rymb
跃	rmhk
略	wher
蚯	liom
蛀	liyg
蛇	lijp
唬	rypu
累	wvif
鄂	rsnl
唱	raa
患	llp
啰	rwln
唾	rhjm
唯	rog
啤	rhwj
啥	romr
啸	rlll
崖	umgg
崎	ukmr
崭	ukql
逻	ywln
崔	uog
帷	lbog
崩	ubb
崇	ujmf
崛	usuu
婴	bov
圈	wfqu
铐	opjks
铛	opfsm
铝	oprr
铜	opbmr
铭	opnir
铲	opyth
银	opav
矫	okhkl
甜	hrtm
秸	hdgr
梨	hnd
犁	hnhq
秽	hduni
移	hdnin
笨	hdm
笼	hikp
笛	hlw
笙	hhqm
符	hodi
第	hnlh
敏	oyok
做	ojrk
袋	opyhv
悠	okp
偿	ofbi
偶	owlb
偎	owmv
偷	oomn
您	ofp
售	ogr
停	oyrn
偏	ohsb
躯	hhsk
兜	hvhu
假	orse
衅	htfq
徘	holmy
徙	hoylo
得	hoami
衔	hoopn
盘	hybt
舶	hyha
船	hycr
舵	hyjp
斜	odyj
盒	orbt
鸽	orpym
敛	omok
悉	hdp
欲	crno
彩	bdhhh
领	oimbo
脚	bgil
脖	bjbd
脯	bijb
豚	bmso
脸	bomm
脱	bcru
象	napo
够	prnin
逸	ynai
猜	khqmb
猪	khjka
猎	khta
猫	khtw
凰	hnhag
猖	khaa
猛	khndt
祭	bommf
馅	nvnhx
馆	nvjrr
凑	imqkk
减	imihr
毫	yrbu
烹	yrnf
庶	itf
麻	ijcc
庵	iklu
痊	komg
痒	ktq
痕	kav
廊	iiil
康	ile
庸	ilb
鹿	ixp
盗	iobt
章	ytaj
竟	ytahu
商	ycbr
族	ysook
旋	ysono
望	ybhg
率	yioj
阎	lsnhx
阐	lscwj
着	tqbu
羚	tqoii
盖	tgbt
眷	fqbu
粘	fdyr
粗	fdbm
粒	fdyt
断	vdhml
剪	tbnh
兽	cwmr
焊	famj
焕	fnbk
清	eqmb
添	ehkp
鸿	empm
淋	edd
涯	emgg
淹	eklu
渠	esd
渐	ekql
淑	eyfe
淌	efbr
混	eapp
淮	eog
淆	ekkb
渊	elfl
淫	ebhg
渔	enwm
淘	epou
淳	eyrd
液	eyok
淤	eysy
淡	eff
淀	ejmo
深	ebcd
涮	esbn
涵	eune
婆	eev
梁	eid
渗	eikh
情	pqmb
惜	pta
惭	pkql
悼	pyaj
惧	pbmc
惕	paph
惟	pog
惊	pyrf
惦	piyr
悴	pyoj
惋	pjnu
惨	pikh
惯	pwjo
寇	jmue
寅	jmlc
寄	jkmr
寂	jyfe
宿	joma
窒	jcmig
窑	jcoju
密	jphu
谋	ivtmd
谍	ivptd
谎	ivtyu
谐	ivppa
袱	loik
祷	ifqki
祸	ifrob
谓	ivwb
谚	ivyhh
谜	ivyfd
逮	yle
敢	mjok
尉	sfdi
屠	sjka
弹	ncwj
隋	nlkmb
堕	nbg
随	nlykb
蛋	nolmi
隅	nlwlb
隆	nlhem
隐	nlnsp
婚	vhpa
婶	vjll
婉	vjnu
颇	dembo
颈	nmmbo
绩	vmqmo
绪	vmjka
续	vmjnk
骑	nmkmr
绰	vmyaj
绳	vmrlu
维	vmog
绵	vmhab
绷	vmbb
绸	vmbgr
综	vmjmf
绽	vmjmo
绿	vmnme
缀	vmeee
巢	vvwd
琴	mgoin
琳	mgdd
琢	mgmso
琼	mgyrf
斑	mgykg
替	qoa
揍	qqkk
款	gfno
堪	gtmv
塔	gtor
搭	qtor
堰	gsav
揩	qppa
越	goiv
趁	goohh
趋	gonsm
超	goshr
揽	qliu
堤	gamo
提	qamo
博	jibi
揭	qapv
喜	grtr
彭	gthhh
揣	qumb
插	qhjx
揪	qhdf
搜	qhxe
煮	jaf
援	qbme
搀	qnuy
裁	jiyhv
搁	qlsr
搓	qtqm
搂	qfdv
搅	qfbu
壹	gbmt
握	qsmg
搔	qeii
揉	qnhd
斯	tchml
期	tcb
欺	tcno
联	sjtk
葫	tjrb
散	tbok
惹	tkrp
葬	tmpt
募	taks
葛	tapv
董	thjg
葡	tpib
敬	trok
葱	tpkp
蒋	tlmi
蒂	tybb
落	tehr
韩	jjqs
朝	jjb
辜	jrytj
葵	tnok
棒	dqkq
棱	dgce
棋	dtmc
椰	dsjl
植	djbm
森	ddd
焚	ddf
椅	dkmr
椒	dyfe
棵	dwd
棍	dapp
椎	dog
棉	dhab
棚	dbb
棕	djmf
棺	djrr
榔	diil
椭	dnlb
惠	jip
惑	imp
逼	ymrw
粟	mwfd
棘	dbdb
酣	mwtm
酥	mwhd
厨	mmti
厦	mmue
硬	mrmlk
硝	mrfb
确	mrnbg
硫	mryiu
雁	moog
殖	mnjbm
裂	mnyhv
雄	kiog
颊	ktmbo
雳	mbmks
暂	kla
雅	mhog
翘	jusmm
辈	lykq
悲	lyp
紫	ypvif
凿	tcuj
辉	fubkq
敞	fbok
棠	fbrd
赏	fbrbo
掌	fbrq
晴	aqmb
睐	budt
暑	ajka
最	asje
晰	adhl
量	amwg
鼎	buvml
喷	rjto
喳	rdam
晶	aaa
喇	rdln
遇	ywlb
喊	rihr
遏	yapv
晾	ayrf
景	ayrf
畴	wqki
践	rmij
跋	rmikk
跌	rmhqo
跑	rmpru
跛	rmdhe
遗	ylmo
蛙	ligg
蛛	lihjd
蜓	linkg
蜒	linkm
蛤	liomr
喝	rapv
鹃	rbpym
喂	rwmv
喘	rumb
喉	ronk
喻	romn
啼	rybb
喧	rjmm
嵌	utmo
幅	lbmrw
帽	lbabu
赋	bompm
赌	bojka
赎	bojnk
赐	boaph
赔	boytr
黑	wgf
铸	opqki
铺	opijb
链	opykq
销	opfb
锁	opfbo
锄	opbms
锅	oprob
锈	ophds
锋	ophej
锌	opytj
锐	opcru
甥	hmwks
掰	qchq
短	okmrt
智	ora
氮	onff
毯	huff
氯	onvne
鹅	hipym
剩	hpln
稍	hdfb
程	hdrhg
稀	hdkkb
税	hdcru
筐	hsmg
等	hgdi
筑	hmhn
策	hdb
筛	hllb
筒	hbmr
筏	hoi
答	homr
筋	hbks
筝	hnsd
傲	ogsk
傅	oibi
牌	llhwj
堡	odg
集	ogd
焦	ogf
傍	oybs
储	oiva
皓	hahgr
皖	hajmu
粤	hwmvs
奥	hbk
街	hoggn
惩	hmp
御	hooml
循	hohju
艇	hynkg
舒	ornin
逾	yomn
番	hdw
释	hdeq
禽	oyub
腊	bta
脾	bhwj
腋	byok
腔	bjcm
腕	bjnu
鲁	nwma
猩	khahm
猬	khwb
猾	khbbb
猴	khonk
惫	hewp
然	bkf
馈	nvlmo
馋	nvnuy
装	lgyhv
蛮	yclmi
就	yfiku
敦	ydok
斌	ykmpm
痘	kmrt
痢	khdn
痪	knbk
痛	knib
童	ytwg
竣	ytice
阔	lsehr
善	tgtr
翔	tqsmm
羡	tgimo
普	tca
粪	fdtc
尊	twdi
奠	twk
道	ythu
遂	ytpo
曾	cwa
焰	fnhx
港	etcu
滞	etjb
湖	ejrb
湘	edbu
渣	edam
渤	ejds
渺	ebuh
湿	eatc
温	eabt
渴	eapv
溃	elmo
溅	eboj
滑	ebbb
湃	ehqj
渝	eomn
湾	eycn
渡	eite
游	eysd
滋	etvi
渲	ejmm
溉	eaiu
愤	pjto
慌	ptyu
惰	pkmb
愕	prrs
愣	pwls
惶	phag
愧	phui
愉	pomn
慨	paiu
割	jrln
寒	jtcy
富	jmrw
寓	jwlb
窜	jcll
窝	jcrob
窖	jchgr
窗	jchwk
窘	jcskr
遍	yhsb
雇	hsog
裕	lcor
裤	likq
裙	lskr
禅	ifcwj
禄	ifnme
谢	ivhhi
谣	ivbou
谤	ivybs
谦	ivtxc
犀	sehq
属	shlb
屡	sfdv
强	nrli
粥	nfdn
疏	nmyiu
隔	nlmrb
隙	nlfhf
隘	nltct
媒	vtmd
絮	vrvif
嫂	vhxe
媚	vahu
婿	vnob
登	nomrt
缅	vmmwl
缆	vmliu
缉	vmrsj
缎	vmhje
缓	vmbme
缔	vmybb
缕	vmfdv
骗	nmisb
编	vmisb
骚	nmeii
缘	vmvno
瑟	mgph
鹉	mmpym
瑞	mgumb
瑰	mghui
瑙	mgvvw
魂	mihui
肆	silq
摄	qsje
摸	qtak
填	gjbc
搏	qibi
塌	gasm
鼓	gtje
摆	qwli
携	qogs
搬	qhye
摇	qbou
搞	qyrb
塘	gilr
摊	qeog
聘	sjlws
斟	tvyj
蒜	tmff
勤	tmks
靴	tjop
靶	tjau
鹊	tapym
蓝	tlit
墓	takg
幕	takb
蓬	tyhj
蓄	tyvw
蒲	teib
蓉	tjcr
蒙	tbmo
蒸	tnef
献	jbik
椿	dqka
禁	ddmmf
楚	ddnyo
楷	dppa
榄	dliu
想	dup
槐	dhui
榆	domn
楼	dfdv
概	daiu
赖	dlnbo
酪	mwher
酬	mwill
感	irp
碍	mrami
碘	mrtbc
碑	mrhwj
碎	mryoj
碰	mrttc
碗	mrjnu
碌	mrvne
尴	kulit
雷	mbw
零	mboii
雾	mbhes
雹	mbpru
辐	kqmrw
辑	kqrsj
输	kqomn
督	yebu
频	yhmbo
龄	yuoii
鉴	lic
睛	buqmb
睹	bujka
睦	bugcg
瞄	butw
睫	bujlo
睡	buhjm
睬	bubd
嗜	rjpa
鄙	rwnl
嗦	rjbf
愚	wbp
暖	abme
盟	abbt
歇	avno
暗	ayta
暇	arse
照	arf
畸	wkmr
跨	rmkms
跷	rmjpu
跳	rmlmo
跺	rmhnd
跪	rmnmu
路	rmher
跤	rmyck
跟	rmav
遣	ylmr
蜈	lirvk
蜗	lirob
蛾	lihqi
蜂	lihej
蜕	licru
嗅	rhuk
嗡	rcim
嗓	reed
署	wljka
置	wljbm
罪	wllmy
罩	wlyaj
蜀	wlpli
幌	lbafu
错	opta
锚	optw
锡	opaph
锣	opwln
锤	ophjm
锥	opog
锦	ophab
键	opnkq
锯	opsjr
锰	opndt
矮	okhdv
辞	hrytj
稚	hdog
稠	hdbgr
颓	hnmbo
愁	hfp
筹	hqki
签	homm
简	hlsa
筷	hpdk
毁	hmhne
舅	hxwks
鼠	hxvyv
催	ouog
傻	ohce
像	onao
躲	hhhnd
魁	hiyj
衙	homrn
微	houuk
愈	ombp
遥	ybou
腻	bipo
腰	bmwv
腥	bahm
腮	bwp
腹	boae
腺	bhae
鹏	bbpm
腾	bfqm
腿	byav
鲍	nmpru
猿	khgrv
颖	pdmbo
触	nblmi
解	nbshq
煞	nkf
雏	nsog
馍	nvtak
馏	nvhhw
酱	lnmcw
禀	ywrf
痹	kwml
廓	iydl
痴	kokr
痰	kff
廉	itxc
靖	ytqmb
新	ydhml
韵	yapim
意	ytap
誊	fqymr
粮	fdiav
数	fvok
煎	tbnf
塑	tbg
慈	tvip
煤	ftmd
煌	fhag
满	etmb
漠	etak
滇	ejbc
源	emhf
滤	eypp
滥	elit
滔	ebhx
溪	ebvk
溜	ehhw
漓	eyub
滚	eycv
溢	etct
溯	etub
滨	ejoc
溶	ejcr
溺	enmm
粱	eifd
滩	eeog
慎	pjbc
誉	fcymr
塞	jtcg
寞	jtak
窥	jcqou
窟	jcsuu
寝	jlme
谨	ivtlm
褂	lggy
裸	lwd
福	ifmrw
谬	ivsmh
群	srtq
殿	schne
辟	srytj
障	nlytj
媳	vhup
嫉	vkok
嫌	vtxc
嫁	vjmo
叠	eeem
缚	vmibi
缝	vmyhj
缠	vmiwg
缤	vmjoc
剿	vdln
静	qbnsd
碧	mamr
璃	mgyub
赘	qkbo
熬	gkf
墙	ggcw
墟	gypm
嘉	grtr
摧	quog
赫	gcglc
截	jiog
誓	qlymr
境	gytu
摘	qycb
摔	qyij
撇	qfbk
聚	seooo
慕	takp
暮	taka
摹	takq
蔓	tawe
蔑	twli
蔡	tbof
蔗	titf
蔽	tfbk
蔼	tivv
熙	suf
蔚	tsfi
兢	jujru
模	dtak
槛	dlit
榴	dhhw
榜	dybs
榨	djcs
榕	djcr
歌	mrno
遭	ytwa
酵	mwjkd
酷	mwhgr
酿	mwiav
酸	mwice
碟	mrptd
碱	mrihr
碳	mrumf
磁	mrtvi
愿	mfp
需	mbmbl
辖	kqjqr
辗	kqstv
雌	ympog
裳	fbryv
颗	wdmbo
瞅	buhdf
墅	wng
嗽	rdlo
踊	rmnib
蜻	liqmb
蜡	lita
蝇	lirlu
蜘	liokr
蝉	licwj
嘛	rijc
嘀	rycb
赚	botxc
锹	ophdf
锻	ophje
镀	opite
舞	otniq
舔	hrhkp
稳	hdnsp
熏	hgf
箕	htmc
算	hbut
箩	hwln
管	hjrr
箫	hlll
舆	hxkc
僚	okcf
僧	ocwa
鼻	huwml
魄	hahui
魅	hijd
貌	bhhau
膜	btak
膊	bibi
膀	bybs
鲜	nmtq
疑	pknio
孵	hhsld
馒	nvawe
裹	ywdv
敲	ybye
豪	yrbo
膏	yrbb
遮	yitf
腐	ioib
瘩	ktor
瘟	kwot
瘦	khxe
辣	yjdl
彰	yjhhh
竭	ytapv
端	ytumb
旗	ysotc
精	fdqmb
粹	fdyoj
歉	tcno
弊	fkt
熄	fhup
熔	fjcr
煽	fhsm
潇	etll
漆	edoe
漱	edlo
漂	emwf
漫	eawe
滴	eycb
漾	etge
演	ejmc
漏	esmb
慢	pawe
慷	pile
寨	jtcd
赛	jtco
寡	jmch
察	jbof
蜜	jphi
寥	jsmh
谭	ivmwj
肇	hklq
褐	lapv
褪	lyav
谱	ivtca
隧	nlyto
嫩	vdlk
翠	smyoj
熊	ipf
凳	nthn
骡	nmwvf
缩	vmjoa
慧	qjsmp
撵	qqoq
撕	qtcl
撒	qtbk
撩	qkcf
趣	gosje
趟	gofbr
撑	qfbq
撮	qase
撬	qhuu
播	qhdw
擒	qoyb
墩	gydk
撞	qytg
撤	qybk
增	gcwa
撰	qruc
聪	sjcrp
鞋	tjgg
鞍	tjjv
蕉	togf
蕊	tppp
蔬	tnmu
蕴	tvmt
横	dtlc
槽	dtwa
樱	dbov
橡	dnao
樟	dytj
橄	dmjk
敷	isok
豌	mtjnu
飘	mfhnk
醋	mwta
醇	mwyrd
醉	mwyoj
磕	mrgit
磊	mrmrr
磅	mrybs
碾	mrstv
震	mbmmv
霄	mbfb
霉	mbowy
瞒	butmb
题	aombo
暴	atce
瞎	bujqr
嘻	rgrr
嘶	rtcl
嘲	rjjb
嘹	rkcf
影	afhhh
踢	rmaph
踏	rmea
踩	rmbd
踪	rmjmf
蝶	liptd
蝴	lijrb
蝠	limrw
蝎	liapv
蝌	lihdj
蝗	lihag
蝙	lihsb
嘿	rwgf
嘱	rshb
幢	lbytg
墨	wgfg
镇	opjbc
镐	opyrb
镑	opybs
靠	hgrly
稽	hdiua
稻	hdbhx
黎	hhoe
稿	hdyrb
稼	hdjmo
箱	hdbu
篓	hfdv
箭	htbn
篇	hhsb
僵	omwm
躺	hhfbr
僻	osrj
德	hojwp
艘	hyhxe
膝	bdoe
膛	bfbg
鲤	nmwg
鲫	nmail
熟	yif
摩	icq
褒	yodv
瘪	khup
瘤	khhw
瘫	keog
凛	imywf
颜	yhmbo
毅	yohne
糊	fdjrb
遵	ytwi
憋	fkp
潜	eqoa
澎	egth
潮	ejjb
潭	emwj
鲨	ehnwm
澳	ehbk
潘	ehdw
澈	eybk
澜	elsw
澄	enot
懂	pthg
憔	pogf
懊	phbk
憎	pcwa
额	jrmbo
翩	hbsmm
褥	lmvi
谴	ivylr
鹤	ogpym
憨	mkp
慰	sip
劈	sjsh
履	shoe
豫	nnnao
缭	vmkcf
撼	qirp
擂	qmbw
操	qrrd
擅	qywm
燕	tlpf
蕾	tmbw
薯	twla
薛	thrj
薇	thok
擎	tkq
薪	tydl
薄	teii
颠	jcmbo
翰	jjosm
噩	mgrr
橱	dmmi
橙	dnot
橘	dnhb
整	dkmym
融	mblmi
瓢	mfhvo
醒	mwahm
霍	mbog
霎	mbytv
辙	kqybk
冀	lpwtc
餐	yeoiv
嘴	rypb
踱	rmite
蹄	rmybb
蹂	rmnhd
蟆	litak
螃	liybs
器	rrikr
噪	rrrd
鹦	bvpym
赠	bocwa
默	wfik
黔	wfoin
镜	opytu
赞	hubo
穆	hdhah
篮	hlit
篡	hbui
篷	hyhj
篱	hyub
儒	ombb
邀	yhsk
衡	honkn
膨	bgth
雕	brog
鲸	nmyrf
磨	icmr
瘾	knlp
瘸	kkrb
凝	impko
辨	yjilj
辩	yjivj
糙	fdyhr
糖	fdilr
糕	fdtgf
燃	fbkf
濒	eyho
澡	errd
激	ehsk
懒	pdlo
憾	pirp
懈	pnbq
窿	jcnlm
壁	sjg
避	ysrj
缰	vmmwm
缴	vmhsk
戴	jiwtc
擦	qjbf
藉	tqda
鞠	tjpfd
藏	tims
藐	tbhu
檬	dtbo
檐	dncr
檀	dywm
礁	mrogf
磷	mrfdq
霜	mbdbu
霞	mbrse
瞭	bukcf
瞧	buogf
瞬	bubbq
瞳	buytg
瞩	bushb
瞪	bunot
曙	awla
蹋	rmasm
蹈	rmbhx
螺	liwvf
蟋	lihdp
蟀	liyij
嚎	ryro
赡	boncr
穗	hdjip
魏	hvhui
簧	htlc
簇	hysk
繁	okvif
徽	houfk
爵	bwli
朦	btbo
臊	brrd
鳄	nmrrs
癌	krru
辫	yjvmj
赢	ynbo
糟	fdtwa
糠	fdile
燥	frrd
懦	pmbb
豁	jrcor
臀	seb
臂	sjb
翼	smwtc
骤	nmseo
藕	tqdb
鞭	tjomk
藤	tbfe
覆	mwhoe
瞻	buncr
蹦	rmubb
嚣	rrmor
镰	opitc
翻	hwsmm
鳍	nmjpa
鹰	iogm
瀑	eate
襟	lddf
璧	sjmgi
戳	sgi
孽	tjnd
警	tkymr
蘑	ticr
藻	terd
攀	ddkq
曝	aate
蹲	rmtwi
蹭	rmcwa
蹬	rmnot
巅	ujco
簸	htce
簿	heii
蟹	nqlmi
颤	ymmbo
靡	iclmy
癣	knmq
瓣	yjhoj
羹	tgftk
鳖	fknwm
爆	fate
疆	ngmwm
鬓	shjoc
壤	gyrv
馨	gehda
耀	fusmg
躁	rmrrd
蠕	limbb
嚼	rbwi
嚷	ryrv
巍	uhvi
籍	hqda
鳞	nmfdq
魔	ichui
糯	fdmbb
灌	etrg
譬	sjymr
蠢	qalii
霸	mbtjb
露	mbrmr
霹	mbsrj
躏	rmtlg
黯	wfyta
髓	bbykb
赣	yjheo
囊	jbrrv
镶	opyrv
瓤	yvhvo
罐	outrg
矗	jmjmm
乂	k
乜	pn
兀	mu
弋	ip
孑	nnm
孓	nno
幺	vi
亓	mml
韦	qs
廿	t
丏	mlvs
卅	tj
仄	mo
厄	msu
仃	omn
仉	ohn
仂	oks
兮	cmvs
刈	kln
爻	kk
卞	yy
闩	lsm
讣	ivy
尹	sk
夬	dk
爿	vlm
毋	wjh
邗	mjnl
邛	mnl
艽	tkn
艿	tnhs
札	du
叵	sr
匝	slb
丕	mfm
匜	spd
劢	msks
卟	ry
叱	rp
叻	rks
仨	ommm
仕	og
仟	ohj
仡	oon
仫	ohi
仞	oshi
卮	hmsu
氐	hpm
犰	khkn
刍	nsm
邝	inl
邙	yvnl
汀	emn
讦	ivmj
讧	ivm
讪	ivu
讫	ivon
尻	skn
阡	nlhj
尕	nsf
弁	it
驭	nme
匡	smg
耒	qd
玎	mgmn
玑	mghn
邢	mtnl
圩	gmd
圬	gmms
圭	gg
扦	qhj
圪	gon
圳	glll
圹	gi
扪	qlis
圮	gsu
圯	gru
芊	thj
芍	tpm
芄	tkni
芨	tnhe
芑	tsu
芎	tn
芗	tvvh
亘	mam
厍	mkq
夼	klll
戍	ihi
尥	kupi
乩	yru
旯	akn
曳	lwp
岌	unhe
屺	usu
凼	ue
囡	wv
钇	opn
缶	oju
氘	onll
氖	onnhs
牝	hqp
伎	oje
伛	osk
伢	omvh
佤	omvn
仵	ooj
伥	opo
伧	oosu
伉	oyhn
伫	ojm
囟	hwk
汆	oe
刖	bln
夙	hnmni
旮	kna
刎	phln
犷	khi
犸	khnvm
舛	niq
凫	pysn
邬	pmnl
饧	nvnsh
汕	eu
汔	eon
汐	eni
汲	enhe
汜	eru
汊	eei
忖	pdi
忏	phj
讴	ivsk
讵	ivss
祁	ifnl
讷	ivob
聿	lq
艮	av
厾	ngi
阱	nltt
阮	nlmmu
阪	nlhe
丞	nem
妁	vpi
牟	ihq
纡	vmmd
纣	vmdi
纥	vmon
纨	vmkni
玕	mgmj
玙	mgysm
抟	qqni
抔	qmf
圻	ghml
坂	ghe
坍	gby
坞	gpvm
抃	qyy
抉	qdk
㧐	qee
芫	tmmu
邯	tmnl
芸	tmmi
芾	tjb
苈	tmks
苣	tss
芷	tylm
芮	tob
苋	tbhu
芼	thqu
苌	tpo
苁	too
芩	toin
芪	thvp
芡	tno
芟	thne
苄	tyy
苎	tjm
苡	tvio
杌	dmu
杓	dpm
杞	dsu
杈	dei
忑	myp
孛	jbnd
邴	mbnl
邳	mmnl
矶	mrhn
奁	ksk
豕	msho
忒	ipp
欤	ymno
轫	kqshi
迓	ymvh
邶	lmpnl
忐	ymp
卣	yws
邺	tcnl
旰	amj
呋	rqo
呒	rmku
呓	rtn
呔	rki
呖	rmks
呃	rmsu
旸	ansh
吡	rpp
町	wmn
虬	liu
呗	rbo
吽	rhq
吣	rp
吲	rnl
帏	lbqs
岐	uje
岈	umvh
岘	ubhu
岑	uoin
岚	uhnk
兕	ssuu
囵	wop
囫	wphh
钊	opln
钋	opy
钌	opnn
迕	yoj
氙	onu
氚	onlll
牤	hqyv
佞	ommv
邱	omnl
攸	olok
佚	ohqo
佝	opr
佟	ohey
佗	ojp
伽	oksr
彷	hoyhs
佘	ommf
佥	omfm
孚	bnd
豸	bshh
坌	cshg
肟	bmms
邸	hmnl
奂	nbk
劬	prks
狄	khf
狁	khihu
鸠	knpym
邹	nsnl
饨	nvpu
饩	nvomn
饪	nvhg
饫	nvhk
饬	nvoks
亨	yrnn
庑	imku
庋	ije
疔	kmn
疖	ksl
肓	yvb
闱	lsqs
闳	lski
闵	lsyk
羌	tghu
炀	fnsh
沣	eqj
沅	emmu
沔	emls
沤	esk
沌	epu
沏	epsh
沚	eylm
汩	ea
汨	ea
沂	ehml
汾	ecsh
沨	ehnk
汴	eyy
汶	eyk
沆	eyhn
沩	eiks
泐	enls
怃	pmku
怄	psk
忡	pl
忤	poj
忾	pomn
怅	ppo
忻	phml
忪	pci
怆	posu
忭	pyy
忸	png
诂	ivjr
诃	ivmnr
诅	ivbm
诋	ivhvi
诌	ivnsm
诏	ivshr
诒	ivir
孜	ndok
陇	nlikp
陀	nljp
陂	nldhe
陉	nlnom
妍	vmt
妩	vmku
妪	vsk
妣	vpp
妊	vhg
妗	voin
妫	viks
妞	vng
姒	vvio
妤	vnin
邵	srnl
劭	srks
刭	nmln
甬	nibq
邰	irnl
纭	vmmmi
纰	vmpp
纴	vmhg
纶	vmop
纾	vmnin
玮	mgqs
玡	mgmvh
玭	mgpp
玠	mgoll
玢	mgcsh
玥	mgb
玦	mgdk
盂	mdbt
忝	hkp
匦	skqn
坩	gtm
抨	qmfj
拤	qymy
坫	gyr
拈	qyr
垆	gys
抻	qlwl
劼	grks
拃	qos
拊	qodi
坼	ghmy
坻	ghpm
㧟	qes
坨	gjp
坭	gsp
抿	qrvp
坳	gvis
耶	sjnl
苷	ttm
苯	tdm
苤	tmfm
茏	tikp
苫	tyr
苜	tbu
苴	tbm
苒	tgb
苘	tbr
茌	tog
苻	todi
苓	toii
茚	thpl
茆	thhl
茑	tpym
茓	tjc
茔	tbg
茕	tbnj
茀	tlln
苕	tshr
枥	dmks
枇	dpp
杪	dfh
杳	da
枧	dbhu
杵	doj
枨	dpo
枞	doo
枋	dyhs
杻	dng
杷	dau
杼	dnin
矸	mrmj
砀	mrnsh
刳	ksln
奄	klwu
瓯	skmvn
殁	mnhne
郏	ktnl
轭	kqmsu
郅	mgnl
鸢	ippym
盱	bumd
昊	amk
昙	ammi
杲	ad
昃	amo
咂	rslb
呸	rmfm
昕	ahml
昀	apmm
旻	ayk
昉	ayhs
炅	af
咔	rymy
畀	wml
虮	lihn
咀	rbm
呷	rwl
黾	rlwu
呱	rhvo
呤	roii
咚	rhey
咆	rpru
咛	rjmn
呶	rve
呣	rwyi
呦	rvis
咝	rvvm
岢	umnr
岿	ulls
岬	uwl
岫	ulw
帙	lbhqo
岣	upr
峁	uhhl
刿	unln
迥	ybr
岷	urvp
剀	uuln
帔	lbdhe
峄	ueq
沓	ea
囹	woii
罔	btyv
钍	opg
钎	ophj
钏	oplll
钒	ophni
钕	opv
钗	opei
邾	hdnl
迮	yos
牦	hqhqu
竺	hmm
迤	yopd
佶	ogr
佬	ojkp
佰	oma
侑	okb
侉	okms
臾	hxo
岱	opu
侗	obmr
侃	orhu
侏	ohjd
侩	oomi
佻	olmo
佾	ocb
侪	oykl
佼	oyck
佯	otq
侬	ohbv
帛	halb
阜	hrj
侔	oihq
徂	hobm
刽	oiln
郄	kinl
怂	oop
籴	ofd
瓮	cimn
戗	oui
肼	btt
䏝	bqni
肽	bki
肱	bki
肫	bpu
剁	hdln
迩	ynf
郇	panl
狙	khbm
狎	khwl
狍	khpru
狒	khlln
咎	hor
炙	bf
枭	pysd
饯	nvij
饴	nvir
冽	immnn
冼	imhgu
庖	ipru
疠	kms
疝	ku
疡	knsh
兖	ycihu
妾	ytv
劾	yoks
炜	fqs
𬉼	fsk
炖	fpu
炘	fhml
炝	fosu
炔	fdk
泔	etm
沭	eijc
泷	eikp
泸	eys
泱	elbk
泅	ewo
泗	ewc
泠	eoii
泺	ehvd
泖	ehhl
泫	eyvi
泮	efq
沱	ejp
泯	ervp
泓	eni
泾	enom
怙	pjr
怵	pijc
怦	pmfj
怛	pam
怏	plbk
怍	pos
㤘	pnsm
㤘	qnsm
怩	psp
怫	plln
怿	peq
宕	jmr
穹	jcn
宓	jph
诓	ivsmg
诔	ivqd
诖	ivgg
诘	ivgr
戾	hsik
诙	ivkf
戽	hsyj
郓	bqnl
衩	lei
祆	ifmk
祎	ifqs
祉	ifylm
祇	ifhvp
诛	ivhjd
诜	ivhgu
诟	ivhmr
诠	ivomg
诣	ivpa
诤	ivnsd
诧	ivjhp
诨	ivbkq
诩	ivsmm
戕	vmi
孢	ndpru
亟	mem
陔	nlyvo
妲	vam
妯	vlw
姗	vbbm
帑	velb
弩	ven
孥	vend
驽	venvm
虱	nhli
迦	yksr
迨	yir
绀	vmtm
绁	vmpt
绂	vmike
驷	nmwc
驸	nmodi
绉	vmnsm
绌	vmuu
驿	nmeq
骀	nmir
甾	vvw
珏	mgmgi
珐	mggi
珂	mgmnr
珑	mgikp
玳	mgoip
珀	mgha
顸	mjmbo
珉	mgrvp
珈	mgksr
拮	qgr
垭	gmtc
挝	qydi
垣	gmam
挞	qyk
垤	gmig
赳	govl
贲	jtbo
垱	gfsm
垌	gbmr
郝	gcnl
垧	ghbr
垓	gyvo
挦	qsmi
垠	gav
茜	tmcw
荚	tkt
荑	tkn
贳	ptbo
荜	tppj
莒	trhr
茼	tbmr
茴	twr
茱	thjd
莛	tnkg
荞	thkl
茯	toik
荏	tohg
荇	thon
荃	tomg
荟	tomi
荀	tpa
茗	tnir
荠	tykl
茭	tyck
茨	tmmo
垩	mcg
荥	tbe
荦	tbhq
荨	tsmi
荩	tsoy
剋	juln
荪	tndf
茹	tvr
荬	tnyk
荮	tvmi
柰	dmmf
栉	dtsl
柯	dmnr
柘	dmr
栊	dikp
柩	dsno
枰	dmfj
栌	dys
柙	dwl
枵	drms
柚	dlw
枳	drc
柞	dos
柝	dhmy
栀	dhmu
柢	dhpm
栎	dhvd
枸	dpr
柈	dfq
柁	djp
枷	dksr
柽	deg
剌	dlln
酊	mwmn
郦	mbnl
甭	mfbq
砗	mrkq
砘	mrpu
砒	mrpp
斫	mrhml
砭	mrhio
砜	mrhnk
奎	kgg
耷	ksj
虺	mulmi
殂	mnbm
殇	mnonh
殄	mnohh
殆	mnir
轱	kqjr
轲	kqmnr
轳	kqys
轶	kqhqo
轸	kqohh
虿	mslmi
毖	ppph
觇	yrbhu
尜	fkf
哐	rsmg
眄	bumls
眍	busk
𠳐	rqjl
郢	rgnl
眇	bufh
眊	buhqu
眈	bulbu
禺	wlbi
哂	rmcw
咴	rkf
曷	apvo
昴	ahhl
昱	ayt
昵	asp
咦	rkn
哓	rjpu
哔	rppj
畎	wik
毗	wpp
呲	rymp
胄	lwb
畋	wok
畈	whe
虼	lion
虻	liyv
盅	lbt
咣	rfmu
哕	runi
剐	rbln
郧	ronl
咻	rod
囿	wkb
咿	rosk
哌	rhhv
哙	romi
哚	rhnd
咯	rher
咩	rtq
咤	rjhp
哝	rhbv
哏	rav
哞	rihq
峙	ugdi
峣	ujpu
罘	wlmf
帧	lbybo
峒	ubmr
峤	uhkl
峋	upa
峥	unsd
贶	borhu
钚	opmf
钛	opki
钡	opbo
钣	ophe
钤	opoin
钨	oppvm
钫	opyhs
钯	opau
氡	onhey
氟	onlln
牯	hqjr
郜	hrnl
秕	hdpp
秭	hdlxh
竽	hmd
笈	hnhe
笃	hnvm
俦	oqki
俨	omth
俅	oije
俪	ombb
叟	hxle
垡	oig
牮	ophq
俣	ormk
俚	owg
皈	hahe
俑	onib
俟	oiok
逅	yhmr
徇	hopa
徉	hotq
舢	hyu
俞	ombn
郗	kbnl
俎	oobm
郤	crnl
爰	bmke
郛	bdnl
瓴	oimvn
胨	bkd
胪	bys
胛	bwl
胂	blwl
胙	bos
胍	bhvo
胗	bohh
胝	bhpm
朐	bpr
胫	bnom
鸨	pjpym
匍	pijb
狨	khij
狯	khomi
飑	hnpru
狩	khjdi
狲	khndf
訇	pymr
逄	yheq
昝	hoa
饷	nvhbr
饸	nvomr
饹	nvher
胤	lvbu
孪	ycnd
娈	ycv
弈	yct
奕	yck
庥	iod
疬	kmks
疣	kiku
疥	koll
疭	koo
庠	itq
竑	ytki
彦	yhhhh
飒	ythnk
闼	lsyk
闾	lsrr
闿	lsusu
阂	lsyvo
羑	tgno
迸	ytt
籼	fdu
酋	tcwm
炳	fmob
炻	fmr
炽	frc
炯	fbr
烀	fhfd
炷	fyg
烃	fnom
洱	esj
洹	emam
洧	ekb
洌	emnn
浃	ekt
洇	ewk
洄	ewr
洙	ehjd
涎	enkm
洎	ehbu
洫	ehbt
浍	eomi
洮	elmo
洵	epa
浒	eivj
浔	esmi
浕	esoy
洳	evr
恸	pmis
恓	pmcw
恹	pmik
恫	pbmr
恺	pusu
恻	pbon
恂	ppa
恪	pher
恽	pbkq
宥	jkb
扃	hsbr
衲	lob
衽	lhg
衿	loin
袂	ldk
祛	ifgi
祜	ifjr
祓	ifikk
祚	ifos
诮	ivfb
祗	ifhpm
祢	ifnf
诰	ivhgr
诳	ivkhg
鸩	lupym
昶	iea
郡	srnl
咫	sorc
弭	nsj
牁	vmmnr
胥	nob
陛	nlppg
陟	nlylh
娅	vmtc
姮	vmam
娆	vjpu
姝	vhjd
姣	vyck
姘	vtt
姹	vjhp
怼	eip
羿	smt
炱	irf
矜	nhoin
绔	vmkms
骁	nmjpu
骅	nmopj
绗	vmhon
绛	vmheq
骈	nmtt
耖	qdfh
挈	qhq
珥	mgsj
珙	mgtc
顼	mgmbo
珰	mgfsm
珩	mghon
珧	mglmo
珣	mgpa
珞	mgher
琤	mgbsd
珲	mgbkq
敖	gsok
恚	ggp
埔	gijb
埕	grhg
埘	gadi
埙	grbo
埚	grob
挹	qrau
耆	jpa
耄	jphqu
埒	gbdi
捋	qbdi
贽	qibo
垸	gjmu
捃	qskr
盍	gibt
荸	tjbd
莆	tijb
莳	tadi
莴	trob
莪	thqi
莠	thds
莓	towy
莜	tolk
莅	toyt
荼	tomd
莩	tbnd
荽	tbv
莸	tkhu
荻	tkhf
莘	tytj
莎	tefh
莞	tjmu
莨	tiav
鸪	jrpym
莼	tvmu
栲	djks
栳	djkp
郴	ddnl
桓	dmam
桡	djpu
桎	dmig
桢	dybo
桤	dusu
梃	dnkg
栝	dhjr
桕	dhx
桁	dhon
桧	domi
桅	dnmu
栟	dtt
桉	djv
栩	dsmm
逑	yije
逋	yijb
彧	ikrm
鬲	mrbl
豇	mtm
酐	mwmj
逦	ymbb
厝	mta
孬	mfvnd
砝	mrgi
砹	mrtk
砺	mrmms
砧	mryr
砷	mrlwl
砟	mros
砼	mrom
砥	mrhpm
砣	mrjp
剞	krln
砻	ipmr
轼	kqipm
轾	kqmig
辂	kqher
鸫	kdpym
趸	msryo
龀	yup
鸬	yspym
虔	ypyk
逍	yfb
眬	buikp
唛	rqme
晟	aihs
眩	buyvi
眙	buir
哧	rglc
哽	rmlk
唔	rmmr
晁	almo
晏	ajv
鸮	rspym
趵	rmpm
趿	rmnhe
畛	wohh
蚨	liqo
蚜	limvh
蚍	lipp
蚋	liob
蚬	libhu
蚝	lihqu
蚧	lioll
唢	rfbo
圄	wmmr
唣	rhap
唏	rkkb
盎	lkbt
唑	roog
崂	utbs
崃	udt
罡	wlmym
罟	wljr
峪	ucor
觊	uubhu
赅	boyvo
钰	opmgi
钲	opmym
钴	opjr
钵	opdm
钹	opike
钺	opiv
钽	opam
钼	opbu
钿	opw
铀	oplw
铂	opha
铄	ophvd
铆	ophhl
铈	opylb
铉	opyvi
铊	opjp
铋	opph
铌	opsp
铍	opdhe
䥽	opive
铎	opeq
氩	onmtc
氤	onwk
氦	onyvo
毪	huihq
舐	hrhvp
秣	hddj
秫	hdijc
盉	hdbt
笄	hmt
笕	hbhu
笊	hhlo
笏	hphh
笆	hau
俸	oqkq
倩	oqmb
俵	oqmv
偌	otkr
俳	olmy
俶	oyfe
倬	oyaj
倏	olok
恁	ogp
倭	ohdv
倪	ohxu
俾	ohwj
倜	obgr
隼	ogj
隽	ognhs
倌	ojrr
倥	ojcm
臬	hud
皋	hakj
郫	hjnl
倨	osjr
衄	htng
颀	hlmbo
徕	hodt
舫	hyyhs
釜	ckmgc
奚	bvik
衾	oinv
胯	bkms
胱	bfmu
胴	bbmr
胭	bwk
脍	bomi
胼	btt
朕	btk
脒	bfd
胺	bjv
鸱	hipym
玺	nfmgi
鸲	prpym
狷	khrb
猁	khhdn
狳	khomd
猃	khomm
狺	khymr
逖	ykhf
桀	nqd
袅	pysv
饽	nvjbd
凇	imdci
栾	ycd
挛	ycq
亳	yrbp
疳	ktm
疴	kmnr
疸	kam
疽	kbm
痈	kbq
疱	kpru
痂	kksr
痉	knom
衮	ycihv
凋	imbgr
颃	ynmbo
恣	mop
旆	ysojb
旄	ysohu
旃	ysoby
阃	lswd
阄	lsnwu
訚	lsymr
阆	lsiav
恙	tgp
粑	fdau
朔	tub
郸	cjnl
烜	fmam
烨	fopj
烩	fomi
烊	ftq
剡	ffln
郯	ffnl
烬	fsoy
涑	edl
浯	emmr
涞	edt
涟	eykq
娑	ehv
涅	eag
涠	ewqs
浞	eryo
涓	erb
浥	erau
涔	euon
浜	eomc
浠	ekkb
浣	ejmu
浚	eice
悚	pdl
悭	pleg
悝	pwg
悒	prau
悌	pcnh
悛	pice
宸	jmmv
窈	jcvis
剜	juln
诹	ivsje
冢	bmso
诼	ivmso
袒	lam
袢	lfq
祯	ifybo
诿	ivhdv
谀	ivhxo
谂	ivoip
谄	ivnhx
谇	ivyoj
屐	shoe
屙	snlr
陬	nlsje
勐	ntks
奘	vgk
牂	vmtq
蚩	umli
陲	nlhjm
姬	vsll
娠	vmmv
娌	vwg
娉	vlws
娲	vrob
娩	vnau
娴	vlsd
娣	vcnh
娓	vshu
婀	vnlr
畚	ikw
逡	yice
绠	vmmlk
骊	nmmbb
绡	vmfb
骋	nmlws
绥	vmbv
绦	vmhed
绨	vmcnh
骎	nmsme
邕	vvrau
鸶	vvmpm
彗	qjsm
耜	qdrlr
焘	qif
舂	qkhx
琏	mgykq
琇	mghds
麸	qeqo
揶	qsjl
埴	gjbm
埯	gklu
捯	qmgn
掳	qyps
掴	qwmi
埸	gaph
埵	ghjm
赧	gcsle
埤	ghwj
捭	qhwj
逵	ygcg
埝	goip
堋	gbb
堍	gnai
掬	qpfd
鸷	qipym
掖	qyok
捽	qyoj
掊	qytr
堉	gyib
掸	qcwj
捩	qhsk
掮	qhsb
悫	gbhp
埭	gle
埽	gsmb
掇	qeee
掼	qwjo
聃	sjgb
菁	tqmb
萁	ttmc
菘	tdci
堇	tlqm
萘	tkmf
萋	tjlv
菽	tyfe
菖	taa
萜	tlbr
萸	thxo
萑	tog
棻	tcsd
菔	tbse
菟	tnai
萏	tnhx
萃	tyoj
菏	temr
菹	tebm
菪	tjmr
菅	tjrr
菀	tjnu
萦	tbvf
菰	tndo
菡	tune
梵	ddhni
梿	dykq
梏	dhgr
觋	mobhu
桴	dbnd
桷	dnbg
梓	dytj
棁	dcru
桫	defh
棂	dsmf
啬	gcwr
郾	svnl
匮	slmo
敕	dlok
豉	mtje
鄄	mgnl
酞	mwki
酚	mwcsh
戛	mui
硎	mrmtn
硭	mrtyv
硒	mrmcw
硖	mrkt
硗	mrjpu
硐	mrbmr
硇	mrhwk
硌	mrher
鸸	mbpym
瓠	kshvo
匏	kspru
厩	maiu
龚	iptc
殒	mnrbo
殓	mnomm
殍	mnbnd
赉	dtbo
雩	mbmms
辄	kqsju
堑	klg
眭	bugg
眦	buymp
啧	rqmo
晡	aijb
晤	ammr
眺	bulmo
眵	bunin
眸	buihq
圊	wqmb
喏	rtkr
喵	rtw
啉	rdd
勖	auks
晞	akkb
唵	rklu
晗	aoir
冕	anau
啭	rkqi
畦	wgg
趺	rmqo
啮	rymu
跄	rmosu
蚶	litm
蛄	lijr
蛎	limms
蛆	libm
蚰	lilw
蛊	libt
圉	wgtj
蚱	lios
蛉	lioii
蛏	lieg
蚴	livis
啁	rbgr
啕	rpou
唿	rphp
啐	ryoj
唼	rytv
唷	ryib
啖	rff
啵	rede
啶	rjmo
啷	riil
唳	rhsk
唰	rsbn
啜	reee
帻	lbqmo
崚	ugce
崦	uklu
帼	lbwmi
崮	uwjr
崤	ukkb
崆	ujcm
赇	boije
赈	bommv
赊	boomf
铑	opjkp
铒	opsj
铗	opkt
铙	opjpu
铟	opwk
铠	opusu
铡	opbon
铢	ophjd
铣	ophgu
铤	opnkg
铧	opopj
铨	opomg
铩	opkd
铪	opomr
铫	oplmo
铬	opher
铮	opnsd
铯	opnau
铰	opyck
铱	opyhv
铳	opyiu
铵	opjv
铷	opvr
氪	onjru
牾	hqmmr
鸹	hrpym
秾	hdhbv
逶	yhdv
笺	hij
筇	hmnl
笸	hsr
笪	ham
笮	hos
笠	hyt
笥	hsmr
笤	hshr
笳	hksr
笾	hyks
笞	hir
偾	ojto
偃	osav
偕	oppa
偈	oapv
傀	ohui
偬	opkp
偻	ofdv
皑	hausu
皎	hayck
鸻	homnm
徜	hofbr
舸	hymnr
舻	hyys
舴	hyos
舷	hyyvi
龛	orikp
翎	oismm
脬	bbnd
脘	bjmu
脲	bse
匐	pmrw
猗	khkmr
猡	khwln
猞	khomr
猝	khyoj
斛	nbyj
猕	khnnf
馗	knthu
馃	nvwd
馄	nvapp
鸾	ycpym
孰	ydkni
庹	itso
庾	ihxo
痔	kgdi
痍	kkn
疵	kymp
翊	ytsmm
旌	ysohm
旎	ysosp
袤	ynhv
阇	lsjka
阈	lsirm
阉	lsklu
阊	lsaa
阋	lshxu
阍	lshpa
阏	lsysy
羟	tqnom
粝	fdmms
粕	fdha
敝	fbok
焐	fmmr
烯	fkkb
焓	foir
烽	fhej
焖	flsp
烷	fjmu
焗	fssr
渍	eqmo
渚	ejka
淇	etmc
淅	edhl
淞	edci
渎	ejnk
涿	emso
淖	eyaj
挲	ehq
淠	ewml
涸	ewjr
渑	erlu
淦	ec
淝	ebau
淬	eyoj
涪	eytr
淙	ejmf
涫	ejrr
渌	enme
淄	evvw
惬	pskt
悻	pgtj
悱	plmy
惝	pfbr
惘	pbtv
悸	phdd
惆	pbgr
惚	pphp
惇	pyrd
惮	pcwj
窕	jclmo
谌	ivtmv
谏	ivdwf
扈	hsrau
皲	bqdhe
谑	ivypm
裆	lfsm
袷	lomr
裉	lav
谒	ivapv
谔	ivrrs
谕	ivomn
谖	ivbme
谗	ivnuy
谙	ivyta
谛	ivybb
谝	ivisb
逯	yvne
郿	aunl
隈	nlwmv
粜	uufd
隍	nlhag
隗	nlhui
婧	vqmb
婊	vqmv
婕	vjlo
娼	vaa
婢	vhwj
婵	vcwj
胬	veobo
袈	kryhv
翌	smyt
恿	nbp
欸	ikno
绫	vmgce
骐	nmtmc
绮	vmkmr
绯	vmlmy
绱	vmfbr
骒	nmwd
绲	vmapp
骓	nmog
绶	vmbbe
绺	vmhyr
绻	vmfqu
绾	vmjrr
骖	nmikh
缁	vmvvw
耠	qdomr
琫	mgqkq
琵	mgpp
琶	mgau
琪	mgtmc
瑛	mgtlk
琦	mgkmr
琥	mgypu
琨	mgapp
靓	qbbhu
琰	mgff
琮	mgjmf
琯	mgjrr
琬	mgjnu
琛	mgbcd
琚	mgsjr
辇	qokq
鼋	mmuu
揳	qqhk
堞	gptd
搽	qtod
揸	qdam
揠	qsav
堙	gmwg
趄	gobm
揖	qrsj
颉	grmbo
塄	gwls
揿	qopo
耋	jpmig
揄	qomn
蛩	mnlmi
蛰	qilmi
塆	gycn
摒	qsyj
揆	qnok
掾	qvno
聒	sjhjr
葑	tggi
葚	ttmv
靰	tjmu
靸	tjnhe
葳	tihv
葺	trsj
葸	twp
萼	trrs
葆	tord
葩	thau
葶	tyrn
蒌	tfdv
萱	tjmm
戟	jji
葭	trse
楮	djka
棼	ddcsh
椟	djnk
棹	dyaj
椤	dwln
棰	dhjm
赍	jbbo
椋	dyrf
椁	dyrd
椪	dttc
棣	dle
椐	dsjr
鹁	jdpym
覃	mwaj
酤	mwjr
酢	mwos
酡	mwjp
鹂	mbpym
厥	mtuo
殚	mncwj
殛	mnmem
雯	mbyk
雱	mbyhs
辊	kqapp
辋	kqbtv
椠	kld
辍	kqeee
辎	kqvvw
斐	lyyk
睄	bufb
睑	buomm
睇	bucnh
睃	buice
戢	rji
喋	rptd
嗒	rtor
喃	rjbj
喱	rmwg
喹	rkgg
晷	ahor
喈	rppa
跖	rmmr
跗	rmodi
跞	rmhvd
跚	rmbt
跎	rmjp
跏	rmksr
跆	rmir
蛱	likt
蛲	lijpu
蛭	limig
蛳	lillb
蛐	litw
蛔	liwr
蛞	lihjr
蛴	liykl
蛟	liyck
蛘	litq
喁	rwlb
喟	rwb
啾	rhdf
嗖	rhxe
喑	ryta
嗟	rtqm
喽	rfdv
嗞	rtvi
喀	rjhr
喔	rsmg
喙	rvno
嵘	utbd
嵖	udam
崴	uihv
遄	yumb
詈	wlymr
嵎	uwlb
崽	uwp
嵬	uhui
嵛	uomn
嵯	utqm
嵝	ufdv
嵫	utvi
幄	lbsmg
嵋	uahu
赕	boff
铻	opmmr
铼	opdt
铿	opleg
锃	oprmg
锂	opwg
锆	ophgr
锇	ophqi
锉	opoog
锏	oplsa
锑	opcnh
锒	opiav
锔	opssr
锕	opnlr
掣	hnq
矬	okoog
氰	onqmb
毳	huhuu
毽	hunkq
犊	hqjnk
犄	hqkmr
犋	hqbmc
鹄	hrpym
犍	hqnkq
嵇	hdiuu
黍	hdoe
稃	hdbnd
稂	hdiav
筚	hppj
筵	hnkm
筌	homg
傣	oqke
傈	omwd
舄	hxpf
牍	lljnk
傥	ofbu
傧	ojoc
遑	yhag
傩	oeog
遁	yhju
徨	hohag
媭	hov
畲	ommw
弑	kdipm
颌	ormbo
翕	orsmm
釉	bdlw
鹆	crpym
舜	bbnq
貂	bhshr
腈	bqmb
腌	bklu
腓	blmy
腆	btbc
腴	bhxo
腑	bioi
腚	bjmo
腱	bnkq
鱿	nmiku
鲀	nmpu
鲂	nmyhs
颍	pembo
猢	khjrb
猹	khdam
猥	khwmv
飓	hnbmc
觞	nbonh
觚	nbhvo
猱	khnhd
颎	pfmbo
飧	nioiv
馇	nvdam
馊	nvhxe
亵	yqiv
脔	ycobo
裒	yhxv
痣	kgp
痨	ktbs
痦	kmmr
痞	kmfr
痤	koog
痫	klsd
痧	kefh
赓	iloo
竦	ytdl
瓿	yrmvn
啻	ybr
颏	yombo
鹇	ldpym
阑	lsdwf
阒	lsbuk
阕	lsnok
粞	fdmcw
遒	ytcw
孳	tvid
焯	fyaj
焜	fapp
焙	fytr
焱	fff
鹈	chpym
湛	etmv
渫	eptd
湮	emwg
湎	emwl
湜	eamo
渭	ewb
湍	eumb
湫	ehdf
溲	ehxe
湟	ehag
溆	eode
湲	ebme
湔	etbn
湉	ephr
渥	esmg
湄	eahu
滁	enld
愠	pabt
惺	pahm
愦	plmo
惴	pumb
愀	phdf
愎	poae
愔	pyta
喾	fbhgr
寐	jvmd
谟	ivtak
扉	hslmy
裢	lykq
裎	lrhg
裥	llsa
祾	ifgce
祺	iftmc
谠	ivfbu
幂	bakb
谡	ivwce
谥	ivtct
谧	ivpht
遐	yrse
孱	sndd
弼	nman
巽	rutc
骘	nhnvm
媪	vabt
媛	vbme
婷	vyrn
巯	nmyiu
翚	smbkq
皴	iedhe
婺	nkv
骛	nknvm
缂	vmtlj
缃	vmdbu
缄	vmihr
彘	vmpop
缇	vmamo
缈	vmbuh
缌	vmwp
缑	vmonk
缒	vmyhr
缗	vmrpa
飨	vhoiv
耢	qdtbs
瑚	mgjrb
瑁	mgabu
瑜	mgomn
瑗	mgbme
瑄	mgjmm
瑕	mgrse
遨	ygsk
骜	qknvm
韫	qsabt
髡	shmu
塬	gmhf
鄢	mfnl
趔	gomnn
趑	gommo
摅	qypp
摁	qwkp
蜇	qllmi
搋	qhyu
搪	qilr
搐	qyvw
搛	qtxc
搠	qtub
摈	qjoc
彀	gnhne
毂	gqhne
搦	qnmm
搡	qeed
蓁	tqkd
戡	tvi
蓍	tjpa
鄞	tmnl
靳	tjhml
蓐	tmvi
蓦	takm
鹋	twpym
蒽	twkp
蓓	toyr
蓖	thwp
蓊	tcim
蒯	tbln
蓟	tnmn
蓑	tywv
蒿	tyrb
蒺	tkok
蓠	tyub
蒟	tytr
蒡	tybs
蒹	ttxc
蒴	ttub
蒗	teiv
蓥	tbc
颐	slmbo
楔	dqhk
楠	djbj
楂	ddam
楝	ddwf
楫	drsj
楸	dhdf
椴	dhje
槌	dyhr
楯	dhju
皙	dlha
榈	dlsr
槎	dtqm
榉	dfcq
楦	djmm
楣	dahu
楹	dnst
椽	dvno
裘	ieyhv
剽	mfln
甄	mgmvn
酮	mwbmr
酰	mwhgu
酯	mwpa
酩	mwnir
蜃	mvlmi
碛	mrqmo
碓	mrog
硼	mrbb
碉	mrbgr
碚	mrytr
碇	mrjmo
碜	mrikh
鹌	kupym
辏	kqqkk
龃	yubm
龅	yupru
訾	ypymr
粲	yefd
虞	yprvk
睚	bumgg
嗪	rqkd
韪	aoqs
嗷	rgsk
嗉	rqmf
睨	buhxu
睢	buog
雎	bmog
睥	buhwj
嘟	rjal
嗑	rgit
嗫	rsje
嗬	rtor
嗔	rjbc
嗝	rmrb
戥	ami
嗄	rmue
煦	arf
暄	ajmm
遢	yasm
暌	anok
跬	rmgg
跶	rmyk
跸	rmppj
跐	rmymp
跣	rmhgu
跹	rmyhj
跻	rmykl
蛸	lifb
蜊	lihdn
蜍	liomd
蜉	libnd
蜣	litgu
畹	wjnu
蛹	linib
嗣	rbsmr
嗯	rwkp
嗥	rhaj
嗲	rckn
嗳	rbbe
嗌	rtct
嗍	rtub
嗨	reoy
嗐	rjqr
嗤	rumi
嗵	rynb
罨	wlklu
嵊	uhdp
嵩	uyrb
嵴	ufcb
骰	bbhne
锗	opjka
锛	opkjt
锜	opkmr
锝	opami
锞	opwd
锟	opapp
锢	opwjr
锨	ophlo
锩	opfqu
锭	opjmo
锱	opvvw
雉	okog
氲	onabt
犏	hqhsb
歃	mxno
稞	hdwd
稗	hdhwj
稔	hdoip
筠	hgpm
筢	hqau
筮	hmoo
筲	hfb
筱	holk
牒	llptd
煲	odf
敫	hsok
徭	hobou
愆	hnp
艄	hyfb
觎	onbhu
毹	onhqu
貊	bhma
貅	bhod
貉	bhher
颔	ormbo
腠	bqkk
腩	bjbj
腼	bmwl
腭	brrs
腧	bomn
塍	bfqg
媵	bfqv
詹	ncymr
鲅	nmike
鲆	nmmfj
鲇	nmyr
鲈	nmys
稣	nmhd
鲋	nmodi
鲐	nmir
肄	pklq
鹐	nxpym
飕	hnhxe
觥	nbfmu
遛	yhhw
馐	nvtqg
鹑	ydpym
亶	ywrm
瘃	kmso
痱	klmy
痼	kwjr
痿	khdv
瘐	khxo
瘁	kyoj
瘆	kikh
麂	iphn
裔	yvbcr
歆	yano
旒	ysoyu
雍	yvhg
阖	lsgit
阗	lsjbc
阙	lstuo
羧	tqice
豢	fqmso
粳	fdmlk
猷	twik
煳	fjrb
煜	fayt
煨	fwmv
煅	fhje
煊	fjmm
煸	fhsb
煺	fyav
滟	eqju
溱	eqkd
溘	egit
漭	etit
滢	etbi
溥	eibi
溧	emwd
溽	emvi
裟	ehyhv
溻	easm
溷	ewmo
滗	ehhu
滫	eolb
溴	ehuk
滏	eckc
滃	ecim
滦	eycd
溏	eilr
滂	eybs
滓	ejyj
溟	ebac
滪	enno
愫	pqmf
慑	psje
慊	ptxc
鲎	fbnwm
骞	jtcm
窦	jcjnk
窠	jcwd
窣	jcyoj
裱	lqmv
褚	ljka
裨	lhwj
裾	lsjr
裰	leee
禊	ifqhk
谩	ivawe
谪	ivycb
媾	vttb
嫫	vtak
媲	vhwp
嫒	vbbe
嫔	vjoc
媸	vumi
缙	vmmca
缜	vmjbc
缛	vmmvi
辔	vmr
骝	nmhhw
缟	vmyrb
缡	vmyub
缢	vmtct
缣	vmtxc
骟	nmism
耥	qdfbr
璈	mggsk
瑶	mgbou
瑭	mgilr
獒	gkik
觏	tbbhu
慝	srp
嫠	jkmv
韬	qsbhx
叆	mibbe
髦	shhqu
摽	qmwf
墁	gawe
撂	qwhr
摞	qwvf
撄	qbov
翥	jasmm
踅	qlryo
摭	qitf
墉	gilb
墒	gycb
榖	gdhne
綦	tcvif
蔫	tmyf
蔷	tgcw
靺	tjdj
靼	tjam
鞅	tjlbk
靿	tjvis
甍	twln
蔸	thvu
蔟	tysk
蔺	tlsg
戬	mai
蕖	tesd
蔻	tjme
蓿	tjoa
斡	jjoyj
鹕	jrbpm
蓼	tsmh
榛	dqkd
榧	dsly
榻	dasm
榫	dogj
榭	dhhi
槔	dhaj
榱	dywv
槁	dyrb
槟	djoc
槠	diva
榷	dobg
僰	dbo
酽	mwmth
酶	mwowy
酹	mwbdi
厮	mtcl
碡	mrqmy
碴	mrdam
碣	mrapv
碲	mrybb
磋	mrtqm
臧	imsll
豨	mokkb
殡	mnjoc
霆	mbnkg
霁	mbykl
辕	kqgrv
蜚	lylmi
裴	lyyhv
翡	lysmm
龇	yuymp
龈	yuav
睿	ybmcu
䁖	bufdv
睽	bunok
嘞	rtjs
嘈	rtwa
嘌	rmwf
嘁	rihf
嘎	rmui
暧	abbe
暝	abac
踌	rmqki
踉	rmiav
蜞	litmc
蜥	lidhl
蜮	liirm
蝈	liwmi
蜴	liaph
蜱	lihwj
蜩	libgr
蜷	lifqu
蜿	lijnu
螂	liiil
蜢	lindt
嘘	rypc
嘡	rfbg
鹗	rspym
嘣	rubb
嘤	rbov
嘚	rhoi
嗾	rysk
嘧	rjpu
罴	wlgif
罱	wljbj
幔	lbawe
嶂	uytj
幛	lbytj
赙	boibi
罂	booju
骷	bbjr
骶	bbhpm
鹘	bbpym
锲	opqhk
锴	opppa
锶	opwp
锷	oprrs
锸	ophjx
锵	oplmi
镁	optgk
镂	opfdv
犒	hqyrb
箐	hqmb
箦	hqmo
箧	hskt
箍	hqsb
箸	hjka
箬	htkr
箅	hwml
箪	hcwj
箔	heha
箜	hjcm
箢	hjnu
箓	hvne
毓	oyyiu
僖	ogrr
儆	otrk
僳	omwd
僭	omua
劁	ofln
僮	oytg
魃	hiikk
魆	hiiv
睾	hwgtj
艋	hyndt
鄱	hwnl
膈	bmrb
膑	bjoc
鲑	nmgg
鲔	nmkb
鲚	nmykl
鲛	nmyck
鲟	nmsmi
獐	khytj
觫	nbdl
雒	hrog
夤	nijmc
馑	nvtlm
銮	ycc
塾	yig
麽	idhi
瘌	kdln
瘊	konk
瘘	kfdv
瘙	keii
廖	ismh
韶	yashr
旖	ysokr
膂	yvb
阚	lsnjk
鄯	trnl
鲞	fqnwm
粿	fdwd
粼	fqvv
粽	fdjmf
糁	fdikh
槊	tbd
鹚	tipym
熘	fhhw
熥	fynb
潢	etlc
漕	etwa
滹	eypd
漯	ewvf
漶	ellp
潋	eomk
潴	ekha
漪	ekhr
漉	eixp
漳	eytj
漩	eyso
澉	emjk
潍	evmg
慵	pilb
搴	jtcq
窨	jcyta
寤	jvmr
綮	hkvif
谮	ivmua
褡	ltor
褙	llpb
褓	lord
褛	lfdv
褊	lhsb
谯	ivogf
谰	ivlsw
谲	ivnhb
暨	auam
屣	shoo
鹛	aupym
嫣	vmyf
嫱	vgcw
嫖	vmwf
嫦	vfbb
嫚	vawe
嫘	vwvf
嫡	vycb
鼐	nsbul
翟	smog
瞀	nkbu
鹜	nkpym
骠	nmmwf
缥	vmmwf
缦	vmawe
缧	vmwvf
缨	vmbov
骢	nmhwp
缪	vmsmh
缫	vmvvd
耦	qdwlb
耧	qdfdv
瑾	mgtlm
璜	mgtlc
璀	mguog
璎	mgbov
璁	mghwp
璋	mgytj
璇	mgyso
奭	kmaa
髯	shgb
髫	shshr
撷	qgro
撅	qmto
赭	gcjka
撸	qnwa
鋆	gmc
撙	qtwi
撺	qjcl
墀	gseq
聩	sjlmo
觐	tmbhu
鞑	tjyk
蕙	tjip
鞒	tjhkl
蕈	tmwj
蕨	tmto
蕤	tmom
蕞	tase
蕺	trji
瞢	twlu
蕃	thdw
蕲	tcjl
赜	slqmo
槿	dtlm
樯	dgcw
槭	dihf
樗	dmbs
樘	dfbg
樊	ddk
槲	dnbj
醌	mwapp
醅	mwytr
靥	mikw
魇	miki
餍	mikv
磔	mrnqd
磙	mrycv
霈	mbejb
辘	kqixp
龉	yummr
龊	yuryo
觑	ycbhu
瞌	bugit
瞋	bujbc
瞑	bubac
嘭	rgth
噎	rgbt
噶	rtav
颙	wbmbo
暹	yaog
噘	rmto
踔	rmyaj
踝	rmwd
踟	rmokr
踒	rmhdv
踬	rmhjo
踮	rmiyr
踯	rmtkl
踺	rmnkq
踞	rmsjr
蝽	liqka
蝾	litbd
蝻	lijbj
蝰	likgg
蝮	lioae
螋	lihxe
蝓	liomn
蝣	liysd
蝼	lifdv
噗	rtco
嘬	rase
颚	rsmbo
噍	rogf
噢	rhbk
噙	royb
噜	rnwa
噌	rcwa
噔	rnot
颛	ubmbo
幞	lbtco
幡	lbhdw
嶙	ufdq
嶝	unot
骺	bbhmr
骼	bbher
骸	bbyvo
镊	opsje
镉	opmrb
镌	opogs
镍	ophud
镏	ophhw
镒	optct
镓	opjmo
镔	opjoc
稷	hdwce
箴	hihr
篑	hlmo
篁	hhag
篌	honk
篆	hvno
牖	llhsb
儋	oncr
徵	hougk
磐	hemr
虢	biypu
鹞	bupym
膘	bmwf
滕	bfqe
鲠	nmmlk
鲡	nmmbb
鲢	nmykq
鲣	nmleg
鲥	nmadi
鲧	nmhvf
鲩	nmjmu
獗	khmto
獠	khkcf
觯	nbcwj
馓	nvtbk
馔	nvruc
麾	ichqu
廛	iwcg
瘛	kqhp
瘼	ktak
瘢	khye
瘠	kfcb
齑	yklll
羯	tqapv
羰	tqumf
𥻗	fddam
遴	yfdq
糌	fdhoa
糍	fdtvi
糅	fdnhd
熜	fhwp
熵	fycb
熠	fsma
澍	egti
澌	etcl
潸	eddb
潦	ekcf
潲	ehdb
鋈	ekc
潟	ehxf
潼	eytg
潺	esnd
憬	payf
憧	pytg
寮	jkcf
窳	jchoo
谳	ivjbk
褴	llit
褟	lasm
褫	lhyu
谵	ivncr
熨	sif
屦	shov
嬉	vgrr
勰	kswp
戮	shi
蝥	nklmi
缬	vmgro
缮	vmttr
缯	vmcwa
骣	nmsnd
畿	viw
耩	qdttb
耨	qdmvi
耪	qdybs
璞	mgtco
璟	mgayf
靛	qbjmo
璠	mghdw
璘	mgfdq
聱	gksj
螯	gklmi
髻	shgr
髭	shymp
髹	shod
擀	qjjj
熹	grtf
甏	ghmvn
擞	qfvk
縠	gfhne
磬	gemr
颞	sembo
蕻	tsic
鞘	tjfb
颟	tbmbo
薤	tmnm
薨	twlp
檠	tkd
薏	tytp
薮	tfvk
薜	tsrj
薅	tvmi
樾	dgov
橛	dmto
橇	dhuu
樵	dogf
檎	doyb
橹	dnwa
樽	dtwi
樨	dseq
橼	dvmo
墼	jeg
橐	jbmrd
翮	mbsmm
醛	mwtog
醐	mwjrb
醍	mwamo
醚	mwyfd
磲	mresd
赝	mogo
飙	ikhnk
殪	mngbt
霖	mbdd
霏	mblmy
霓	mbhxu
錾	klc
辚	kqfdq
臻	mgqkd
遽	yypo
氅	fkhqu
瞟	bumwf
瞠	bufbg
瞰	bumjk
嚄	rtoe
嚆	rtyb
噤	rddf
暾	aydk
蹀	rmptd
踹	rmumb
踵	rmhjg
踽	rmhlb
蹉	rmtqm
蹁	rmhsb
螨	litmb
蟒	litit
螈	limhf
螅	lihup
螭	liyub
螠	litct
螟	libac
噱	rypo
噬	rhmo
噫	rytp
噻	rjtg
噼	rsrj
罹	wlpog
圜	wwlv
䦃	optja
镖	opmwf
镗	opfbg
镘	opawe
镚	opubb
镛	opilb
镝	opycb
镞	opysk
镠	opsmh
氇	hunwa
氆	hutca
憩	hup
穑	hdgcw
篝	httb
篥	hmwd
篦	hhwp
篪	hhyu
篙	hyrb
盥	hxbt
劓	hlln
翱	hjsmm
魉	himob
魈	hifb
徼	hohsk
歙	omno
膳	btgr
膦	bfdq
膙	bnii
鲮	nmgce
鲱	nmlmy
鲲	nmapp
鲳	nmaa
鲴	nmwjr
鲵	nmhxu
鲷	nmbgr
鲻	nmvvw
獴	khtbo
獭	khdlo
獬	khnbq
邂	ynbq
鹧	ifpym
廨	inbq
赟	ymbo
瘰	kwvf
廪	iywf
瘿	kbov
瘵	kbof
瘴	kytj
癃	knlm
瘳	ksmh
斓	yklsw
麇	iphd
麈	ipyg
嬴	ynv
壅	yvgg
羲	tghds
糗	fdhuk
瞥	fkbu
甑	camvn
燎	fkcf
燠	fhbk
燔	fhdw
燧	fyto
濑	edlo
濉	ebug
潞	ermr
澧	etwt
澹	encr
澥	enbq
澶	eywm
濂	eitc
褰	jtcv
寰	jwlv
窸	jchdp
褶	lsma
禧	ifgrr
嬖	sjv
犟	nihq
隰	nlavf
嬗	vywm
颡	edmbo
缱	vmylr
缲	vmrrd
缳	vmwlv
璨	mgyed
璩	mgypo
璐	mgrmr
璪	mgrrd
螫	gklmi
擤	qhul
壕	gyro
觳	gbhne
罄	geoju
擢	qsmg
薹	tgrg
鞡	tjqyt
鞬	tjnkq
薷	tmbb
薰	thgf
藓	tnmq
藁	tyrd
檄	dhsk
檩	dywf
懋	ddp
醢	mwkrt
翳	sesmm
礅	mrydk
磴	mrnot
鹩	kfpym
龋	yuhlb
龌	yusmg
豳	umoo
壑	yeg
黻	tbikk
嚏	rjbo
嚅	rmbb
蹑	rmsje
蹒	rmtmb
蹊	rmbvk
蟥	litlc
螬	litwa
螵	limwf
疃	wytg
螳	lifbg
蟑	liytj
嚓	rjbf
羁	wltjm
罽	wlmfn
罾	wlcwa
嶷	upko
黜	wfuu
黝	wfvis
髁	bbwd
髀	bbhwj
镡	opmwj
镢	opmto
镣	opkcf
镦	opydk
镧	oplsw
镩	opjcl
镪	opnri
镫	opnot
罅	ouypd
黏	heyr
簌	hdlo
篾	hwli
篼	hhvu
簖	hvdl
簋	havt
鼢	hvcsh
黛	opwgf
儡	owww
鹪	ofpym
鼾	hlmj
皤	hahdw
魍	hibtv
龠	omrb
繇	buhvf
貘	bhtak
邈	ybhu
貔	bhhwp
臌	bgte
膻	bywm
臆	bytp
臃	byvg
鲼	nmjto
鲽	nmptd
鳀	nmamo
鳃	nmwp
鳅	nmhdf
鳇	nmhag
鳊	nmisb
螽	hylii
燮	ffe
鹫	yupym
襄	yrrv
糜	icfd
縻	idvif
膺	iogb
癍	kmgg
麋	ipfd
懑	ebp
濡	embb
濮	eoto
濞	ehul
濠	eyro
濯	esmg
蹇	jtco
謇	jtcr
邃	yjco
襁	lnii
檗	sjd
擘	sjq
孺	ndmbb
隳	nbop
嬷	vidi
蟊	nhlii
鹬	nbpym
鍪	nkc
鏊	gkc
鳌	qknwm
鬈	shfqu
鬃	shjmf
瞽	gebu
鞯	tjtkd
鞨	tjapv
鞫	tjpyr
鞧	tjtcw
鞣	tjnhd
藜	thhe
藠	thaa
藩	tehw
醪	mwsmh
蹙	ifryo
礓	mrmwm
燹	mof
餮	mhoiv
瞿	buog
曛	ahgf
颢	afmbo
曜	asmg
躇	rmtja
蹚	rmfbg
鹭	rrpym
蟛	ligth
蟪	lijip
蟠	lihdw
蟮	littr
鹮	wvpym
黠	wfgr
黟	wfnin
髅	bbfdv
髂	bbjhr
镬	optoe
镭	opmbw
镯	opwli
馥	haoae
簟	hmwj
簪	hmua
鼬	hvlw
雠	ogivg
艟	hyytg
鳎	nmasm
鳏	nmwle
鳐	nmbou
癞	kdlo
癔	kytp
癜	ksce
癖	ksrj
糨	fdnii
蹩	fkryo
鎏	euc
懵	ptwu
彝	vmfft
邋	yvvv
鬏	shhdf
攉	qmbg
攒	qhuo
鞲	tjttb
鞴	tjthb
藿	tmbg
蘧	tyyo
蘅	thon
麓	ddixp
醮	mwogf
醯	mwyit
酃	mrnl
霪	mbebg
霭	mbivv
霨	mbsfi
黼	tbijb
嚯	rmbg
蹰	rmmmi
蹶	rmmto
蹽	rmkcf
蹼	rmtco
蹴	rmyfu
蹾	rmydk
蹿	rmjcl
蠖	litoe
蠓	litbo
蟾	lincr
蠊	liitc
黢	wfice
髋	bbjtu
髌	bbjoc
镲	opjbf
籀	hqhw
籁	hdlo
齁	hlpr
魑	hiyub
艨	hytbo
鳓	nmtjs
鳔	nmmwf
鳕	nmmbs
鳗	nmawe
鳙	nmilb
麒	iptmc
鏖	ipc
羸	yntq
㸆	fhgy
瀚	ejjm
瀣	eyem
瀛	eynv
襦	lmbb
谶	ivoim
襞	sjyhv
骥	nmlpc
缵	vmhuo
瓒	mghuo
攘	qyrv
蘩	tokf
蘖	tjd
醴	mwtwt
霰	mbtbk
酆	utnl
矍	buoge
曦	atgs
躅	rmwli
鼍	rrwmu
巉	unri
黩	wfjnk
黥	wfyrf
黪	wfikh
镳	opipf
镴	opvvv
黧	hhwgf
纂	hbuf
璺	hbmgi
鼯	hvmmr
臜	bhuo
鳜	nmmto
鳝	nmttr
鳟	nmtwi
獾	khtrg
孀	vmbu
骧	nmyrv
瓘	mgtrg
鼙	gehwj
醺	mwhgf
礴	mrtei
颦	yohwj
曩	ayrv
鳢	nmtwt
癫	kjco
麝	iphhi
夔	tche
爝	fbwi
灏	eafo
禳	ifyrv
鐾	sjc
羼	stqq
蠡	volii
耱	qdidr
懿	gtmop
蘸	tmgf
鹳	tgpym
霾	mbbhg
氍	bghqu
饕	ruoiv
躐	rmvvv
髑	bbwli
镵	opnri
穰	hdyrv
饔	yvgv
鬻	nnmrb
鬟	shwlv
趱	gohuo
攫	qbue
攥	qhbf
颧	tgmbo
躜	rmhuo
鼹	hvajv
癯	kbug
麟	ipfdq
蠲	ttwli
蠹	jbmri
躞	rmffe
衢	hobgn
鑫	ccc
灞	embb
襻	lddq
纛	qmwyf
鬣	shvvv
攮	qjbv
囔	rjbv
馕	nvjbv
戆	yop
爨	hbddf
齉	hljbv
亍	mmn
尢	ku
彳	ho
卬	hvsl
殳	hne
𠙶	unn
毌	wj
邘	mdnl
戋	ij
圢	gmn
氕	onl
伋	onhe
仝	om
冮	imm
氿	ekn
汈	esm
氾	esu
忉	psh
宄	jkn
𬣙	ivmd
讱	ivshi
扞	qmj
圲	ghj
圫	ghp
芏	tg
芃	thni
朳	dc
朸	dks
𨙸	jenl
邨	punl
吒	rhp
吖	rcl
屼	umu
屾	uu
辿	yu
钆	opu
仳	opp
伣	obhu
伈	op
癿	hau
甪	hbq
邠	chnl
犴	khmj
冱	immvm
邡	ysnl
闫	lsmmm
𬇕	ems
汋	epi
䜣	ivhml
讻	ivuk
𬣞	ivjm
孖	ndnd
𬘓	vmlll
纩	vmi
玒	mgm
玓	mgpi
玘	mgsu
玚	mgnsh
刬	ijln
𫭟	gsk
坜	gmks
坉	gpu
扽	qpu
𫭢	gop
坋	gcsh
扺	qhvp
㧑	qiki
㧑	qiks
毐	gwj
芰	tje
芣	tmf
苊	tmsu
苉	tsc
芘	tpp
芴	tphh
芠	tyk
𫇭	tiks
芤	tndu
杕	dk
杙	dip
杄	dhj
杧	dyv
杩	dnvm
尪	kumg
尨	iuhhh
轪	kqk
𫐄	kqmu
坒	ppg
芈	tq
旴	amd
旵	au
呙	rob
㕮	rck
岍	umt
𫵷	umks
岠	uss
岜	uau
呇	er
冏	bcr
觃	bund
岙	hku
伾	omfm
㑇	onsm
伭	oyvi
佖	oph
伲	osp
佁	oir
飏	hnnsh
狃	khng
闶	lsyhn
汧	emt
汫	ett
𣲘	emku
𣲗	eqs
沄	emmi
沘	epp
𬇙	ebo
汭	eob
㳇	eck
沇	eihu
忮	pje
忳	ppu
忺	pno
𬣡	ivij
祃	ifnvm
诇	ivbr
邲	phnl
诎	ivuu
诐	ivdhe
屃	sbo
𫸩	nsk
岊	auu
阽	nlyr
䢺	uunl
阼	nlos
妧	vmmu
妘	vmmi
𨚕	itnl
纮	vmki
驲	nma
𫘜	nmyk
纻	vmjm
𬘘	vmlbu
𫘝	nmdk
纼	vmnl
玤	mgqj
玞	mgqo
玱	mgosu
玟	mgyk
邽	ggnl
邿	ginl
坥	gbm
坰	gbr
坬	ghvo
坽	goii
弆	git
耵	sjmn
䢼	tcnl
𦭜	trc
茋	thpm
苧	tjmn
苾	tph
苠	trvp
枅	dmt
㭎	dbk
枘	dob
枍	dcms
矼	mrm
矻	mron
匼	somr
𬨂	kqhvp
𬀩	aqs
𬀪	abhu
旿	aoj
昇	aht
昄	ahe
昒	aphh
昈	ahs
咉	rlbk
咇	rph
咍	rir
岵	ujr
岽	ukd
岨	ubm
岞	uos
峂	uhey
㟃	usmr
囷	whd
𬬩	opip
钐	ophhh
钔	oplis
钖	opnsh
牥	hqyhs
佴	osj
垈	opg
侁	ohgu
侹	onkg
佸	ohjr
佺	oomg
隹	og
㑊	oylc
侂	oihp
佽	ommo
侘	ojhp
郈	hrnl
舠	hysh
郐	oinl
郃	ornl
攽	chok
肭	bob
肸	bcj
肷	bno
狉	khmfm
狝	khnf
饳	nvuu
忞	ykp
於	ysoy
炌	foll
炆	fyk
泙	emfj
沺	ew
泂	ebr
泜	ehpm
泃	epr
泇	eksr
怊	pshr
峃	fbu
穸	jcni
祋	ifhne
祊	ifyhs
𫍣	ivbmr
𬣳	ivav
𬩽	sinl
鸤	spym
弢	nue
弨	nshr
陑	nlmbl
𬮿	nlusu
陎	nlhjd
𬯀	nlykl
卺	nemsu
乸	pdwyi
妭	vikk
姈	voii
𫰛	vnom
迳	ynom
叕	eeee
𬳵	nmmfm
驵	nmbm
𬳶	nmbr
䌹	vmbr
驺	nmnsm
𫠊	nmyvi
绋	vmlln
绐	vmir
砉	qjmr
耔	qdnd
㛃	qhv
玶	mgmfj
珇	mgbm
珅	mglwl
𬍛	mghvd
珋	mghhl
玹	mgyvi
珌	mgph
玿	mgshr
韨	qsike
垚	ggg
垯	gyk
垙	gfmu
垲	gusu
埏	gnkm
垍	ghbu
耇	jkpr
鿍	gheq
垎	gher
垴	gyuk
垟	gtq
垞	gjhp
挓	qjhp
垵	gjv
垏	glq
拶	qvvn
荖	tjkp
荁	tmam
荙	tyk
荛	tjpu
茈	tymp
茽	tol
荄	tyvo
茺	tyiu
𬜬	tlsr
荓	ttt
茳	tem
𦰡	tsql
茛	tav
荭	tvmm
㭕	dgi
柷	drhu
柃	doii
柊	dhey
枹	dpru
栐	dine
柖	dshr
郚	mrnl
剅	mtln
䴓	mbpym
迺	ymcw
厖	miuh
砆	mrqo
砑	mrmvh
砄	mrdk
耏	mbhhh
奓	knin
䶮	ipmk
轵	kqrc
轷	kqhfd
轹	kqhvd
轺	kqshr
昺	amob
𪾢	bubhu
昽	aikp
盷	bupim
咡	rsj
咺	rmam
昳	ahqo
昣	aohh
哒	ryk
昤	aoii
昫	apr
昡	ayvi
咥	rmig
昪	ait
虷	limj
虸	lind
哃	rbmr
峘	umam
耑	umbl
峛	umnn
𪨰	utw
峗	unmu
峧	uyck
帡	lbtt
钘	opmt
𫓧	opqo
钜	opss
𬬮	oppo
𬬱	ophml
𬬭	opop
钪	opyhn
钬	opf
钭	opyj
矧	oknl
秬	hdss
俫	odt
舁	hxt
俜	olws
俙	okkb
俍	oiav
垕	hrg
衎	homjn
舣	hyik
弇	ort
侴	omnn
鸧	oupym
䏡	bmmf
胠	bgi
𦙶	bjr
胈	bikk
胩	bymy
胣	bopd
朏	buu
飐	hnyr
訄	knymr
饻	nvyhv
庤	igdi
疢	kf
炣	fmnr
炟	fam
㶲	fbq
洭	esmg
洘	ejks
洓	edb
洿	ekms
㳚	eihi
泚	eymp
浈	eybo
浉	ellb
洸	efmu
洑	eoik
洢	eosk
洈	enmu
洚	eheq
洺	enir
洨	eyck
浐	eyth
㳘	eyiu
洴	ett
洣	efd
恔	pyck
宬	jihs
窀	jcpu
扂	hsyr
袆	lqs
祏	ifmr
祐	ifkr
祕	ifph
叚	rsse
陧	nlag
陞	nlhtg
娀	vij
姞	vgr
姱	vkms
姤	vhmr
姶	vomr
姽	vnmu
枲	ird
绖	vmmig
骃	nmwk
𬘡	vmwk
𬳽	nmhgu
𬘩	vmnkg
𫄧	vmnkv
彖	vnmo
骉	nmnmm
恝	qhp
珪	mggg
珛	mgkb
珹	mgihs
琊	mgmhl
玼	mgymp
珖	mgfmu
𪟝	qoks
珽	mgnkg
珦	mghbr
珫	mgyiu
珒	mglq
𬍤	mgsmi
珢	mgav
珕	mgkss
珝	mgsmm
𫭼	gtbs
埗	gylh
垾	gamj
垺	gbnd
埆	gnbg
垿	ginn
埌	giav
埇	gnib
莰	tgno
茝	tsll
𬜯	tmob
鄀	trnl
莶	tomm
莝	toog
䓖	tjcs
莙	tskr
栻	dipm
桠	dmtc
𬂩	dkt
桄	dfmu
梠	drhr
栴	doby
梴	dnkm
栒	dpa
酎	mwdi
酏	mwpd
𫠆	jembo
砵	mrdm
砠	mrbm
砫	mryg
砬	mryt
硁	mrnom
恧	mbp
翃	kismm
郪	jvnl
𨐈	kqfmu
𨐈	pqfmu
辀	kqhby
辁	kqomg
𬌗	mhomr
剕	lmsyn
赀	ypbo
哢	rmgt
晅	amam
晊	amig
唝	rmbo
哳	rqhl
哱	rjbd
冔	armd
晔	aopj
晐	ayvo
晖	abkq
畖	whvo
蚄	liyhs
蚆	liau
𫑡	runl
帱	lbqki
崁	ugno
峿	ummr
𪨶	ukkq
崄	uomm
帨	lbcru
崀	uiav
赆	bosoy
𬬸	opid
钷	opsr
𬬻	opys
𬬹	oplwl
𬬿	opshr
𬭁	opwyi
眚	hmbu
甡	hmhqm
笫	hlxh
倻	osjl
倴	okjt
脩	olob
倮	owd
倕	ohjm
倞	oyrf
𫢸	ocwj
倓	off
倧	ojmf
衃	htmf
虒	hypu
舭	hypp
舯	hyl
舥	hyau
瓞	hohqo
鬯	uip
鸰	oipym
脎	bkd
朓	blmo
胲	byvo
虓	knypu
鱽	nmsh
狴	khppg
峱	khngu
狻	khice
眢	nubu
𫗧	nvdl
勍	yfks
痄	kos
疰	kyg
痃	kyvi
竘	ytpr
羖	tqhne
羓	tqau
桊	fqd
敉	fdok
烠	fkb
烔	fbmr
烶	fnkg
烻	fnkm
𬊈	fsmi
涍	ejkd
浡	ejbd
浭	emlk
浬	ewg
涄	elws
涢	erbo
涐	ehqi
浰	ehdn
浟	eolk
浛	eoir
浼	enau
浲	ehej
涘	eiok
悈	pit
悃	pwd
悢	piav
𬒈	fbmr
宧	jsll
窅	jcbu
窊	jchvo
窎	jcpym
扅	hsnin
扆	hsyhv
袪	lgi
袗	lohh
袯	live
祧	iflmo
隺	obg
堲	alg
疍	noam
𨺙	nlhxu
陴	nlhwj
烝	nemf
砮	vemr
㛚	vnib
哿	krmnr
翀	sml
翂	smcsh
剟	eeeen
𬳿	nmomd
𫄨	vmkkb
绤	vmcor
骍	nmytj
𬘫	vmjmu
䂮	qhmr
琎	mgytt
珸	mgmmr
珵	mgrhg
琄	mgrb
琈	mgbnd
琀	mgoir
珺	mgskr
掭	qhkp
堎	ggce
堐	gmgg
埼	gkmr
掎	qkmr
埫	gfbr
堌	gwjr
晢	qla
𫮃	gcwj
掞	qff
埪	gjcm
壸	gbmc
㙍	geee
聍	sjjmn
菝	tqik
萚	tqeq
菥	tdhl
莿	tdbn
䓫	tkmr
勚	poks
䓬	tyaj
萆	thwj
菂	thai
菍	toip
菼	tff
萣	tjmo
䓨	tbou
菉	tvne
䓛	tsuu
梼	dqki
梽	dgp
桲	djbd
梾	ddt
桯	drhg
梣	duon
梌	domd
桹	diav
敔	mrok
厣	mikl
硔	mrtc
鿎	mryk
硙	mrusu
硚	mrhkl
硊	mrnmu
硍	mrav
勔	mwks
䴕	mnpym
龁	yuon
逴	yyaj
唪	rqkq
啫	rjka
翈	wlsmm
㫰	aiav
晙	aice
畤	wgdi
𬱖	lwmbo
趼	rmmjj
跂	rmje
蛃	limob
蚲	limfj
𬟽	likd
蚺	ligb
啴	rcwj
䎃	gbsmm
崧	udci
崟	uc
崞	uyrd
崒	uyoj
崌	usjr
崡	uune
铏	opmtn
𫓯	opgg
𫟹	optc
铕	opkb
𫟼	opyk
铖	opihs
铘	opmhl
铚	opmig
铞	oprlb
铥	ophgi
铴	openh
牻	hqiuh
牿	hqhgr
稆	hdrr
笱	hpr
笯	hve
偰	oqhk
偡	otmv
鸺	odpm
偭	omwl
偲	owp
偁	obgb
㿠	hafmu
鄅	hbnl
偓	osmg
徛	hokmr
衒	hoyin
舳	hylw
舲	hyoii
鸼	hypym
悆	omdp
鄃	onnl
瓻	kbmvn
䝙	bhsk
脶	brob
脞	boog
脟	bbdi
䏲	bcnh
鱾	nmsu
猇	khypu
猊	khhxu
猄	khyrf
觖	nbdk
𠅤	ywp
庱	igce
庼	ipmo
庳	ihwj
痓	kmig
䴔	ykpym
竫	ytbsd
堃	ysg
阌	lsbbe
羝	tqhpm
羕	tgine
焆	frb
烺	fiav
焌	fice
淏	eamk
𬇹	ewmi
淟	etbc
淜	ebb
淴	ephp
淯	eyib
湴	ettc
涴	ejnu
𬍡	ehmgi
㥄	pgce
惛	phpa
惔	pff
悰	pjmf
惙	peee
寁	jjlo
逭	yjrr
𬤇	ivmwg
𫍯	ivihr
袼	lher
裈	lbkq
祲	ifsme
𬤊	ivamo
𫍲	ivhxe
谞	ivnob
艴	lnnau
弸	nbb
弶	nyrf
𬯎	nllmo
隃	nlomn
婞	vgtj
娵	vsje
婼	vtkr
媖	vtlk
婳	vmuw
婍	vkmr
婌	vyfe
婫	vapp
婤	vbgr
婘	vfqu
婠	vjrr
𬘬	vmqmb
𬘭	vmdd
𬴂	nmlmy
𫘦	nmpou
绹	vmpou
𫟅	vmyrf
𬘯	vmyrd
骕	nmlll
𫘧	nmnme
絜	qhvif
珷	mgmpm
琲	mglmy
琡	mgyfe
琟	mgog
琔	mgjmo
琭	mgvne
堾	gqka
堼	gig
揕	qtmv
㙘	gmwv
堧	gmbk
喆	grgr
堨	gapv
塅	ghje
堠	gonk
絷	qivif
𪣻	gfdv
𡎚	ghsb
葜	tqhk
惎	tcp
萳	tjbj
葙	tdbu
靬	tjmj
葴	tihr
蒇	tiho
蒈	tppa
鄚	tknl
蒉	tlmo
蓇	tbbb
萩	thdf
蒐	thui
葰	toie
葎	thoq
鄑	manl
蒎	tehv
葖	tjck
蒄	tbmi
萹	thsb
棤	dta
棽	ddoin
棫	dirm
椓	dmso
椑	dhwj
𬃊	dhjo
鹀	mopym
椆	dbgr
棓	dytr
棬	dfqu
棪	dff
椀	djnu
楗	dnkq
𬷕	ibpym
甦	mkhqm
酦	mwive
觌	jkbhu
奡	mukll
皕	mama
硪	mrhqi
欹	krno
詟	ipymr
𫐐	kqhxu
辌	kqyrf
棐	lyd
龂	yuhml
𬹼	yuoll
黹	tcfb
牚	fbrmh
睎	bukkb
晫	ayaj
晪	atbc
晱	aff
𧿹	rmwyi
蛑	liihq
畯	wice
斝	rrbyj
喤	rhag
崶	uggi
嵁	utmv
𫶇	utjb
崾	umwv
嵅	uihr
崿	urrs
嵚	uopo
翙	unsmm
𫖮	uumbo
圌	wumb
圐	wwls
赑	boboo
淼	eee
赒	bobgr
鿏	opqme
铹	optbs
𬭊	opdg
铽	opipp
𨱇	cije
𨱇	opije
𫓶	oprb
锊	opbdi
锍	opyiu
锎	oplst
𬭎	opjki
锓	opsme
犇	hqhqq
颋	ngmbo
稌	hdomd
筀	hgg
筘	hqr
筜	hfsm
筥	hrhr
筅	hhgu
傃	oqmf
傉	omvi
翛	olom
傒	obvk
傕	oobg
舾	hymcw
畬	omdw
𫖯	lmuoo
脿	bqmv
腘	bwmi
䐃	bwhd
腙	bjmf
腒	bsjr
𬱟	numbo
鲃	nmau
猰	khqhk
𫛭	kgpym
猯	khumb
㺄	khomn
馉	nvbbb
凓	immwd
鄗	ybnl
𫷷	iopo
廋	ihxe
廆	ihui
鄌	irnl
粢	mofd
遆	yybb
旐	ysolo
𬮱	lsmwg
焞	fyrd
𬊤	fcwj
欻	ffno
𣸣	ejto
溚	etor
溁	etbd
湝	eppa
渰	eort
湓	ecst
㴔	ensp
渟	eyrn
溠	etqm
渼	etgk
溇	efdv
湣	erpa
湑	enob
溞	eeii
愐	pmwl
愃	pjmm
敩	fdok
甯	jpbq
棨	hkd
扊	hsff
裣	lomm
祼	ifwd
婻	vjbj
媆	vmbk
媞	vamo
㛹	vomk
媓	vhag
媂	vybb
媄	vtgk
毵	ihhqu
矞	nhbcr
𬴃	nmqjr
𫘨	nmamo
缊	vmabt
缐	vmhae
骙	nmnok
瑃	mgqka
瑓	mgdwf
瑅	mgamo
瑆	mgahm
䴖	qbpym
瑖	mghje
瑝	mghag
瑔	mghae
瑀	mghlb
𤧛	mgybb
瑳	mgtqm
瑂	mgahu
嶅	gku
瑑	mgvno
遘	yttb
髢	shpd
塥	gmrb
堽	gwlm
赪	gcybo
摛	qyub
塝	gybs
搒	qybs
搌	qstv
蒱	tqib
蒨	toqb
蓏	thoo
蔀	tyrl
蓢	taib
蓂	tbac
蒻	tnmm
蓣	tnno
椹	dtmv
楪	dptd
榃	ddw
榅	dabt
楒	dwp
楞	dwls
楩	domk
榇	dytd
椸	dysd
楙	dnhd
歅	mgno
𬪩	mwhbv
碃	mrqmb
碏	mrta
𬒔	mrymb
碈	mrhpa
䃅	mrcwj
硿	mrjcm
鄠	msnl
辒	kqabt
𬨎	kqtcw
𫐓	kqnhd
龆	yushr
觜	ypnbg
䣘	fgnl
暕	adwf
鹍	appym
𫫇	rmcp
㬊	abme
暅	apmm
跱	rmgdi
蜐	ligis
蜎	lirb
嵲	uhud
赗	boabu
骱	bboll
锖	opqmb
𫓹	optmc
锘	optkr
锳	optlk
锧	ophjo
锪	opphp
𬭚	opyrd
锫	opytr
锬	opff
𬭛	opede
稑	hdgcg
稙	hdjbm
䅟	hdikh
𬕂	hmbo
筻	hmlk
筼	hrbo
筶	hhgr
筦	hjmu
筤	hiav
傺	obof
鹎	hjpym
僇	osmh
艅	hyomd
艉	hyshu
谼	crtc
貆	bhmam
腽	babt
腨	bumb
腯	bhju
鲉	nmlw
鲊	nmos
鲌	nmha
䲟	nmhpl
𬶋	nmpr
𬶍	nmjp
鲏	nmdhe
雊	prog
猺	khbou
飔	hnwp
觟	nbgg
𦝼	bfdv
馌	nvgit
裛	yrav
廒	igsk
瘀	kysy
瘅	kcwj
鄘	ibnl
鹒	iopym
鄜	ipnl
麀	ipp
鄣	yjnl
阘	lsasm
𫔶	lshud
煁	ftmv
煃	fkgg
煴	fabt
煋	fahm
煟	fwb
煓	fumb
滠	esje
溍	emia
溹	ejbf
滆	emrb
滉	eafu
溦	euuk
溵	ehse
漷	eydl
滧	eykk
滘	ebcr
滍	eumi
愭	pjpa
慥	pyhr
慆	pbhx
塱	ibg
𫌀	lqmo
裼	laph
禋	ifmwg
禔	ifamo
禘	ifybb
禒	ifvno
谫	ivtbh
鹔	llpym
𫖳	srmbo
愍	rkp
嫄	vmhf
媱	vbou
戤	nti
勠	shks
戣	nki
𫘪	nmmhf
𫘬	nmbvk
缞	vmywv
耤	qdta
瑧	mgqkd
𫞩	mgtmb
瑨	mgmia
瑱	mgjbc
瑷	mgbbe
瑢	mgjcr
斠	tbyj
摏	qqkx
墕	gmyf
墈	gtvs
墐	gtlm
墘	gjjn
摴	qmbs
銎	mnc
𡐓	gile
墚	geid
撖	qmjk
𪤗	gsmh
靽	tjfq
鞁	tjdhe
蔌	tdlo
蔈	tmwf
蓰	thoo
蔹	tomk
蔊	tfaj
嘏	jrrse
榰	djpa
榑	dibi
槚	dmwo
𣗋	dfbu
槜	dogs
榍	dsfb
疐	jbwno
𬸘	svpym
酺	mwijb
酾	mwmbb
酲	mwrhg
酴	mwomd
碶	mrqhk
䃎	mrknn
𬒗	mrliu
碨	mrwmv
𥔲	mrrrs
碹	mrjmm
碥	mrhsb
劂	moln
𫚖	ypnwm
䴗	bkpym
夥	wdnin
瞍	buhxe
鹖	avpym
㬎	avif
跽	rmsup
蜾	liwd
幖	lbmwf
嶍	usma
圙	wcmw
𨱏	ctor
𨱏	optor
锺	ophjg
锼	ophxe
锽	ophag
𬭤	oponk
锾	opbme
锿	opyrv
镃	optvi
镄	oplno
镅	opahu
馝	haph
鹙	hfpym
箨	hqeq
箖	hdd
劄	hrln
僬	oogf
僦	oyfu
僔	otwi
僎	oruc
槃	hed
㙦	ojg
鲒	nmgr
鲕	nmmbl
𫚕	nmllb
鲖	nmbmr
鲗	nmbon
鲘	nmhmr
鲙	nmomi
𬶐	nmlmo
𬶏	nmnmu
𩽾	nmjv
夐	nbbue
獍	khytu
飗	hnhhw
𬸚	kkpym
凘	imtcl
廑	itlm
廙	iwtc
瘗	kktg
瘥	ktqm
瘕	krse
鲝	tqnwm
鄫	canl
熇	fyrb
漹	emyf
漖	ejdk
潆	etbf
漤	eddv
潩	ewtc
漼	euog
漴	eujf
㽏	ertm
漈	ebof
漋	enlm
漻	esmh
慬	ptlm
窬	jcomn
窭	jcfdv
㮾	ibd
𬤝	ivjip
褕	lomn
禛	ifjbc
禚	iftgf
隩	nlhbk
嫕	vskp
嫭	vypd
嫜	vytj
嫪	vsmh
𬙂	vmjmc
㻬	mgmbs
麹	qepfd
璆	mgsmh
漦	jkme
叇	miyle
墣	gtco
墦	ghdw
墡	gtgr
劐	teln
薁	thbk
蕰	teat
蔃	tnii
鼒	dhbul
槱	dmwf
鹝	mbpym
磏	mrtxc
磉	mreed
殣	mntlm
慭	dkp
霅	mbymr
暵	atlo
暲	aytj
暶	ayso
踦	rmkmr
踣	rmytr
䗖	litjb
蝘	lisav
蝲	lidln
蝤	litcw
噇	rytg
噂	rtwi
噀	rruc
罶	wlhhw
嶲	uogs
嶓	uhdw
㠇	uyfu
嶟	utwi
嶒	ucwa
镆	optak
镈	opibi
镋	opfbu
镎	oporq
𬭩	opcim
镕	opjcr
稹	hdjbc
儇	owlv
皞	hahaj
皛	hahaa
䴘	hnpym
艎	hyhag
艏	hythu
鹟	cmpym
𩾃	nmnau
鲦	nmhed
鲪	nmskr
鲬	nmnib
橥	kad
觭	nbkmr
鹠	hwpym
鹡	fbpym
糇	fdonk
糈	fdnob
翦	tbnm
鹢	ttpym
鹣	tcpym
熛	fmwf
潖	emgu
潵	etbk
㵐	emto
澂	eugk
澛	enwa
瑬	eumgi
潽	etca
潾	efdq
潏	enhb
憭	pkcf
憕	pnot
𬸣	jtcm
戭	jci
褯	litb
禤	ifwlm
𫍽	ivwlv
嫽	vkcf
遹	ynhb
𬴊	nmfdq
璥	mgtrk
璲	mgyto
璒	mgnot
憙	grtp
擐	qwlv
鄹	sonl
薳	tygv
鞔	tjnau
黇	tcyr
𬞟	tyho
蕗	trmr
薢	tnbq
蕹	tyvg
橞	djip
橑	dkcf
橦	dytg
醑	mwnob
觱	irnbg
磡	mrtvs
𥕢	mrtwa
磜	mrbof
豮	mojto
𫟦	kqyto
𬺈	yukmr
𫠜	yuhxu
鹾	ywtqm
虤	yuypu
暿	agrr
曌	abjcm
曈	aytg
㬚	aybk
蹅	rmdam
踶	rmamo
䗛	liolb
螗	liilr
疁	wsmh
㠓	utbo
幪	lbtbo
𪩘	ujbk
嶦	uncr
𬭬	opqjm
𨱑	ctwc
𨱑	optlc
𬭯	opfbk
馞	hajbd
穄	hdbof
篚	hsly
篯	hopj
簉	hyhr
鼽	hlkn
衠	hojcn
盦	oint
螣	bfqi
縢	bfqf
鲭	nmqmb
鲯	nmtmc
鲰	nmsje
鲺	nmnhi
鲹	nmikh
𫗴	nvywm
亸	ydcwj
癀	ktlc
瘭	kmwf
𬸦	ykpym
羱	tqmhf
糒	fdthb
燋	fogf
熻	form
燊	fffd
燚	ffff
燏	fnhb
濩	etoe
濋	eddo
澪	embi
澽	eypo
澴	ewlv
澭	eyvg
澼	esrj
憷	pddo
憺	pncr
懔	pywf
黉	fbtlc
嬛	vwlv
鹨	shpym
翯	smyrb
𫄷	vmytp
璱	mgmgh
𤩽	mgjbk
璬	mghsk
璮	mgywm
髽	shoog
擿	qyyb
薿	tpko
薸	temf
檑	dmbw
櫆	dhij
檞	dnbq
醨	mwyub
繄	sevif
磹	mrmwj
磻	mrhdw
瞫	bumwj
瞵	bufdq
蹐	rmfcb
蟏	litll
㘎	rlsk
𬭳	opgrr
镤	optco
𬭶	opwgf
𫔍	ophdw
镥	opnwa
镨	optca
𬭸	opfdq
𨱔	ctwi
𨱔	optwi
𬭼	opyto
𫔎	opnhb
矰	okcwa
穙	hdtco
穜	hdytg
穟	hdyto
簕	htjs
簃	hhdn
簏	hixp
儦	oipf
魋	hiog
斶	hlwli
艚	hytwa
𬸪	hwpym
谿	bkcor
䲠	nmqka
𬶟	nmdln
鲾	nmmrw
𬶠	nmdwf
鲿	nmfbi
鳁	nmabt
鳂	nmwmv
鳈	nmhae
鳉	nmlmi
獯	khhgf
䗪	itfi
馘	tuirm
襕	llsw
襚	lyto
𬶨	aunwm
螱	silmi
甓	sjmvn
嬬	vmbb
嬥	vsmg
𦈡	vmmbb
𫄸	vmhgf
瓀	mgmbb
釐	jkmwg
鬶	qumrb
爇	tgif
鞳	tjtor
鞮	tjamo
𬟁	tmbm
藟	twww
藦	ticq
藨	tipf
鹲	topym
檫	djbf
黡	mikf
礞	mrtbo
礌	mrmbw
𥖨	mrrrd
蹢	rmycb
蹜	rmjoa
蟫	limwj
䗴	lihng
嚚	rrslr
髃	bbwlb
镮	opwlv
镱	opytp
酂	honl
馧	hawot
簠	hibt
簝	hkcf
簰	hllj
鼫	hvmr
鼩	hvpr
皦	hahsk
臑	bmbb
䲢	bfqm
鳑	nmybs
鳒	nmtxc
鹱	pmtoe
鹯	ympym
癗	kmbw
𦒍	ygsmm
旞	ysyoo
翷	fqsmm
冁	cjstv
䎖	casmm
瀔	egde
瀍	eiwg
瀌	eipf
襜	lncr
䴙	sryjm
𬙊	vmwgg
嚭	grmfr
㰀	dhhe
鬷	mbuce
醭	mwtco
蹯	rmhdw
蠋	liwli
翾	wvsmm
鳘	oknwm
儳	onri
儴	oyrv
鼗	logte
𬶭	nmbof
𩾌	nmile
鳚	nmsfi
鳛	nmsma
麑	iphxu
麖	ipyrf
蠃	ynlmi
彟	sitoe
嬿	vtlf
鬒	shjbc
蘘	tyrv
欂	dtei
醵	mwypo
颥	mbmbo
甗	ybmvn
𨟠	bgnl
巇	uyti
酅	ubnl
髎	bbsmh
犨	oghq
𬶮	nmgrr
𨭉	ymc
㸌	fmbg
爔	ftgs
瀱	ewln
瀹	eomb
瀼	eyrv
瀵	efdc
襫	lkma
孅	voim
骦	nmmbu
𬙋	vmyrv
耰	qdmbe
𤫉	mgffe
瓖	mgyrv
鬘	shawe
趯	gosmg
𬺓	yuddo
罍	wwwu
鼱	hvqmb
鳠	nmtoe
鳡	nmirp
鳣	nmywm
爟	ftrg
爚	fomb
灈	ebug
韂	tjncr
糵	tjfd
蘼	ticy
礵	mrmbu
鹴	mupym
躔	rmiwg
皭	habwi
龢	obhd
鳤	nmhjr
亹	yhbm
籥	homb
鼷	hvbvk
𫚭	nmvvv
玃	khbue
醾	mwidd
齇	hlypm
觿	nbuob
蠼	libue
