一	m
丁	mn
七	ju
三	mmm
下	my
丈	jk
上	ym
丑	ng
丐	myvs
不	mf
丙	mob
世	pt
丕	mfm
且	bm
丘	om
丞	nem
丟	mgi
並	ttc
丫	cl
中	l
串	ll
丸	kni
凡	hni
丹	by
主	yg
乃	nhs
久	no
么	hi
之	ino
尹	sk
乍	os
乏	hino
乎	hfd
乒	omh
乓	omi
乖	hjlp
乘	hdlp
乙	nu
九	kn
也	pd
乞	on
乩	yru
乳	bdu
乾	jjon
亂	bbu
了	nn
予	ninn
事	jlln
二	mm
于	md
云	mmi
井	tt
互	mvnm
五	mdm
亙	mbm
些	ypmm
亞	mllm
亟	mem
亡	yv
交	yck
亦	ylnc
亥	yvho
亨	yrnn
享	yrnd
京	yrf
亭	yrbn
亮	yrbu
人	o
仁	omm
什	oj
仃	omn
仆	oy
仇	okn
仍	onhs
今	oin
介	oll
仄	mo
以	vio
付	odi
仔	ond
仕	og
他	opd
仗	ojk
代	oip
令	oini
仙	ou
仞	oshi
仿	oyhs
伉	oyhn
伙	of
伊	osk
伕	oqo
伍	omdm
伐	oi
休	od
伏	oik
仲	ol
件	ohq
任	ohg
仰	ohvl
仳	opp
份	ocsh
企	oylm
位	oyt
住	oyg
佇	ojmn
佗	ojp
佞	ommv
伴	ofq
佛	olln
何	omnr
估	ojr
佐	okm
佑	okr
伽	oksr
伺	osmr
伸	olwl
佃	ow
佔	oyr
似	ovio
但	oam
佣	obq
作	oos
你	onf
伯	oha
低	ohpm
伶	ooii
余	omd
佝	opr
佯	otq
依	oyhv
侍	ogdi
佳	ogg
使	ojlk
佬	ojkp
供	otc
例	omnn
來	doo
侃	orhu
佰	oma
併	ott
侈	onin
佩	ohnb
佻	olmo
侖	ombt
佾	ocb
侏	ohjd
信	oymr
侵	osme
侯	onmk
便	omlk
俠	okoo
俑	onib
俏	ofb
保	ord
促	oryo
侶	orhr
俘	obnd
俟	oiok
俊	oice
俗	ocor
侮	oowy
俐	ohdn
俄	ohqi
係	ohvf
俚	owg
俎	oobm
俞	ombn
倌	ojrr
倍	oytr
倣	oysk
俯	oioi
倦	ofqu
倥	ojcm
俸	oqkq
倩	oqmb
倖	ogtj
倆	omlb
值	ojbm
借	ota
倚	okmr
倒	omgn
們	oan
俺	oklu
倀	osmv
倔	osuu
倨	osjr
俱	obmc
倡	oaa
個	owjr
候	olnk
倘	ofbr
俳	olmy
修	oloh
倭	ohdv
倪	ohxu
俾	ohwj
倫	oomb
倉	oiar
偺	ohoa
偽	oikf
停	oyrn
假	orse
偃	osav
偌	otkr
做	ojrk
偉	odmq
健	onkq
偶	owlb
偎	owmv
偕	oppa
偵	oybc
側	obcn
偷	oomn
偏	ohsb
倏	olok
傢	ojmo
傍	oybs
傅	oibi
備	othb
傑	onqd
傀	ohui
傖	ooir
傘	oooj
傭	oilb
債	oqmc
傲	ogsk
傳	ojii
僅	otlm
傾	opmc
催	ouog
傷	ooah
傻	ohce
傯	ohwp
僧	ocwa
僮	oytg
僥	oggu
僖	ogrr
僭	omua
僚	okcf
僕	otco
像	onao
僑	ohkb
僱	ohsg
億	oytp
儀	otgi
僻	osrj
僵	omwm
價	omwc
儂	otwv
儈	ooma
儉	oomo
儒	ombb
儘	olmt
儔	ogni
儐	ojmc
優	ombe
償	ofbc
儡	owww
儲	oyra
儷	ommp
儼	orrk
兀	mu
元	mmu
允	ihu
充	yihu
兄	rhu
光	fmu
兇	ukhu
兆	lmuo
先	hghu
兌	crhu
克	jrhu
兕	ssuu
免	nahu
兔	nahi
兒	hxhu
兗	ycrhu
兜	hvhu
兢	jujru
入	oh
內	ob
全	omg
兩	mlbo
八	ho
六	yc
兮	cmvs
公	ci
共	tc
兵	omc
具	bmmc
其	tmmc
典	tbc
兼	txc
冀	lpwtc
冉	gb
冊	bt
再	mgb
冒	abu
冑	lwb
冕	anau
最	asje
冗	bhn
冠	bmui
冤	bnai
冥	bayc
冢	bmso
冬	hey
冰	ime
冶	imir
冷	imoii
冽	immnn
凍	imdw
凌	imgce
准	imog
凋	imbgr
凜	imywd
凝	impko
几	hn
凰	hnhag
凱	uthn
凳	nthn
凶	uk
凹	ssu
出	uu
凸	bss
函	une
刀	sh
刁	sm
刃	shi
分	csh
切	psh
刈	kln
刊	mjln
列	mnln
刑	mtln
划	iln
刎	phln
別	rsln
判	fqln
利	hdln
刪	btln
刨	puln
刻	yoln
券	fqsh
刷	sbln
刺	dbln
到	mgln
刮	hrln
制	hbln
剁	hdln
剎	kcln
剃	chln
削	fbln
前	tbln
剌	dlln
剋	juln
則	bcln
剖	yrln
剜	juln
剔	ahln
剛	buln
剝	veln
剪	tbnh
副	mwln
割	jrln
剴	utln
創	orln
剩	hpln
剿	vdln
剷	ymln
剽	mfln
劃	lmln
劇	yoln
劈	sjsh
劉	hcln
劍	ooln
劑	yxln
力	ks
加	ksr
功	mks
劣	fhks
劫	giks
助	bmks
努	veks
劬	prks
劾	yoks
勇	nbks
勉	nuks
勃	jdks
勁	mmks
勒	tjks
務	nhoks
勘	tvks
動	hgks
勞	ffbks
勝	bfqs
勛	rcks
募	taks
勦	vdks
勤	tmks
勢	giks
勵	mbks
勸	tgks
勻	pmm
勾	pi
勿	phh
包	pru
匆	pkk
匈	puk
匍	pijb
匐	pmrw
匏	kspru
匕	uh
化	op
北	lmp
匙	aop
匝	slb
匡	smg
匠	shml
匣	swl
匪	slmy
匯	seog
匱	slmc
匹	sc
匿	stkr
區	srrr
匾	shsb
十	j
千	hj
午	oj
升	ht
卅	tj
仟	ohj
半	fq
卉	jt
卒	yooj
協	jkss
卓	yaj
卑	hwhj
南	jbtj
博	jibi
卜	y
卞	yy
卡	ymy
占	yr
卦	ggy
卯	hhsl
卮	hmsu
印	hpsl
危	nmsu
即	aisl
卵	hhsli
卷	fqsu
卸	omsl
卹	htsl
卻	crsl
卿	hhail
厄	msu
厚	mand
原	mhaf
厝	mta
厥	mtuo
厭	mabk
厲	mtwb
去	gi
參	iiih
又	nk
叉	ei
友	ke
及	nhe
反	he
取	sje
叔	yfe
受	bbe
叛	fqhe
叟	hxle
曼	awle
叢	tcte
口	r
可	mnr
古	jr
右	kr
召	shr
叮	rmn
叩	rsl
叨	rsh
叼	rsm
司	smr
叵	sr
叫	rvl
另	rks
只	rc
史	lk
叱	rp
台	ir
句	pr
叭	rc
吉	gr
吏	jlk
同	bmr
吊	rlb
吐	rg
吁	rmd
吋	rdi
各	her
向	hbr
名	nir
合	omr
吃	ron
后	hmr
吆	rvi
吒	rhp
吝	ykr
吭	ryhn
吞	mkr
吾	mmr
否	mfr
呎	rso
吧	rau
呆	rd
呃	rmsu
吳	rvnk
呈	rhg
呂	rhr
君	skr
吩	rcsh
告	hgr
吹	rno
吻	rphh
吸	rnhe
吮	rihu
吵	rfh
吶	rob
吠	rik
吼	rndu
呀	rmvh
吱	rje
含	oinr
吟	roin
味	rjd
呵	rmnr
咖	rksr
呸	rmfm
咕	rjr
咀	rbm
呻	rlwl
呷	rwl
咄	ruu
咒	rrhn
咆	rpru
呼	rhfd
咐	rodi
呱	rhvo
呶	rve
和	hdr
咚	rhey
呢	rsp
周	bgr
咋	ros
命	omrl
咎	hor
咬	ryck
哀	yrhv
咨	mor
哎	rtk
哉	jir
咸	ihmr
咦	rkn
咳	ryvo
哇	rgg
哂	rmcw
咽	rwk
咪	rfd
品	rrr
哄	rtc
哈	romr
咯	rher
咫	sorc
咱	rhbu
咻	rod
哨	rfb
唐	ilr
唁	rymr
唷	ryib
哼	ryrn
哥	mrnr
哲	qlr
唆	rice
哺	rijb
唔	rmmr
哩	rwg
哭	rrik
員	rbuc
唉	riok
哮	rjkd
哪	rsql
哦	rhqi
唧	rail
商	ycbr
啪	rqha
啦	rqyt
啄	rmso
啞	rmlm
啡	rlmy
啃	rymb
啊	rnlr
唱	raa
啖	rff
問	anr
啕	rpou
唯	rog
啤	rhwj
唸	roip
售	ogr
啜	reee
唬	rypu
啣	roml
唳	rhsk
啻	ybr
喀	rjhr
喧	rjmm
啼	rybb
喊	rihr
喝	rapv
喘	rumb
喂	rwmv
喜	grtr
喪	grrv
喔	rsmg
喇	rdln
喋	rptd
喃	rjbj
喳	rdam
單	rrwj
喟	rwb
唾	rhjm
喲	rvfi
喚	rnbk
喻	romn
喬	hkrbr
喱	rmwg
啾	rhdf
喉	ronk
嗟	rtqm
嗨	reoy
嗓	reed
嗦	rjbf
嗎	rsqf
嗜	rjpa
嗇	gowr
嗑	rgit
嗣	rbsmr
嗤	rumi
嗯	rwkp
嗚	rhrf
嗡	rcim
嗅	rhuk
嗆	roir
嗥	rhaj
嗾	rysk
嘀	rycb
嘛	rijc
嘗	fbrpa
嗽	rdlo
嘔	rsrr
嘆	rtlo
嘉	grtr
嘍	rllv
嘎	rmui
嗷	rgsk
嘖	rqmc
嘟	rjal
嘈	rtwa
嘮	rffs
嘻	rgrr
嘹	rkcf
嘲	rjjb
嘿	rwgf
嘩	rtmj
噓	rypm
噎	rgbt
噗	rtco
噴	rjtc
嘶	rtcl
嘯	rlx
嘰	rvii
噙	royb
噫	rytp
噹	rfbw
噩	mgrr
噤	rddf
噸	rpuc
嘴	rypb
噪	rrrd
器	rrikr
噥	rtwv
噱	rypo
噯	rbbe
噬	rhmo
噢	rhbk
嚎	ryro
嚀	rjpn
嚐	rfba
嚅	rmbb
嚇	rgcc
嚏	rjbo
嚕	rnwa
嚮	vlhbr
嚥	rtlf
嚨	rybp
嚷	ryrv
嚶	rbcv
嚴	rrmmk
嚼	rbwi
囁	rsjj
囀	rjji
囂	rrmcr
囈	rtgi
囊	jbrrv
囉	rwlg
囌	rtnd
囑	rsei
四	wc
囚	wo
因	wk
回	wr
囪	hwkk
困	wd
囤	wpu
固	wjr
圃	wijb
圈	wfqu
國	wirm
圍	wdmq
園	wgrv
圓	wrbc
團	wjii
圖	wryw
土	g
圳	glll
地	gpd
在	klg
圭	gg
圬	gmms
圯	gru
坊	gyhs
坑	gyhn
址	gylm
坍	gby
均	gpmm
坎	gno
圾	gnhe
坐	oog
坏	gmf
垃	gyt
坷	gmnr
坪	gmfj
坩	gtm
坡	gdhe
坦	gam
坤	glwl
坼	ghmy
垂	hjtm
型	mng
垠	gav
垣	gmam
垢	ghmr
城	gihs
垮	gkms
埂	gmlk
埔	gijb
埋	gwg
埃	giok
域	girm
堅	seg
堊	mmg
堆	gog
埠	ghrj
埤	ghwj
基	tcg
堂	fbrg
堵	gjka
執	gjkni
培	gytr
堯	gggu
堪	gtmv
場	gamh
堤	gamo
堰	gsav
報	gjsle
堡	odg
塞	jtcg
塑	tbg
塘	gilr
塗	edg
塚	gbmo
塔	gtor
填	gjbc
塌	gasm
塭	gwot
塊	ghui
塢	ghrf
塵	ipg
塾	yig
境	gytu
墓	takg
墊	gig
塹	jlg
墅	wng
墀	gseq
墟	gypm
增	gcwa
墳	gjtc
墜	nog
墮	nbg
壁	sjg
墾	bvg
壇	gywm
壅	yvgg
壕	gyro
壓	mkg
壑	yeg
壙	gitc
壘	wwwg
壞	gywv
壟	ypg
壢	gmhm
壤	gyrv
壩	gmbb
士	jm
壬	hg
壯	vmg
壹	gbmt
壺	gblm
壽	gnmi
夏	muhe
夔	tche
夕	ni
外	niy
夙	hnmni
多	nini
夜	yonk
夠	nnpr
夥	wdnin
夢	twln
夤	nijmc
大	k
天	mk
夫	qo
太	ki
夭	hk
央	lbk
失	hqo
夷	kn
夸	kmms
夾	koo
奉	qkq
奇	kmnr
奈	kmmf
奄	klwu
奔	kjt
奕	yck
契	qhk
奏	qkhk
奎	kgg
奐	nbk
套	ksmi
奘	vgk
奚	bvik
奢	kjka
奠	twk
奧	hbk
奪	kogi
奩	ksrr
奮	kogw
女	v
奴	ve
奶	vnhs
妄	yvv
奸	vmj
妃	vsu
好	vnd
她	vpd
如	vr
妁	vpi
妝	vmv
妒	vhs
妨	vyhs
妞	vng
妣	vpp
妙	vfh
妖	vhk
妍	vmt
妤	vnin
妓	vje
妊	vhg
妥	bv
妾	ytv
妻	jlv
委	hdv
妹	vjd
妮	vsp
姑	vjr
姆	vwyi
姐	vbm
姍	vbt
始	vir
姓	vhqm
姊	vlxh
妯	vlw
妳	vnf
姒	vvio
姜	tgv
姘	vtt
姿	mov
姣	vyck
姨	vkn
娃	vgg
姥	vjkp
姪	vmig
姚	vlmo
姦	vvv
威	ihmv
姻	vwk
娑	ehv
娘	viav
娜	vsql
娟	vrb
娛	vrvk
娓	vshu
姬	vsll
娠	vmmv
娣	vcnh
娩	vnau
娥	vhqi
娌	vwg
娶	sev
婁	llv
婉	vjnu
婦	vsmb
婪	ddv
婀	vnlr
娼	vaa
婢	vhwj
婚	vhpa
婆	eev
婊	vqmv
婷	vyrn
媚	vahu
婿	vnob
媒	vtmd
媛	vbme
嫁	vjmo
嫉	vkok
嫌	vtxc
媾	vttb
媽	vsqf
媼	vwot
媳	vhup
嫂	vhxe
媲	vhwp
嫡	vycb
嫦	vfbb
嫩	vdlk
嫗	vsrr
嫖	vmwf
嫘	vwvf
嫣	vmyf
嬉	vgrr
嫻	vand
嬋	vrrj
嫵	votf
嬌	vhkb
嬝	vhav
嬴	ynv
嬰	bcv
嬪	vjmc
嬤	vici
嬸	vjhw
孀	vmbu
子	nd
孑	nnm
孓	nno
孔	ndu
孕	nsnd
字	jnd
存	klnd
孝	jknd
孜	ndok
孚	bnd
孟	ndbt
孤	ndhvo
季	hdnd
孩	ndyvo
孫	ndhvf
孰	ydkni
孳	tvid
孱	sndd
孵	hhsld
學	hbnd
孺	ndmbb
孽	tjnd
孿	vfnd
它	jp
宇	jmd
守	jdi
宅	jhp
安	jv
完	jmmu
宋	jd
宏	jki
宗	jmmf
定	jmyo
官	jrlr
宜	jbm
宙	jlw
宛	jniu
宣	jmam
宦	jsll
室	jmig
客	jher
宥	jkb
宰	jytj
害	jqmr
家	jmso
宴	jav
宮	jrhr
宵	jfb
容	jcor
宸	jmmv
寇	jmue
寅	jmlc
寄	jkmr
寂	jyfe
宿	joma
密	jphu
寒	jtcy
富	jmrw
寓	jwlb
寐	jvmd
寞	jtak
寧	jpbn
寡	jmch
寥	jsmh
實	jwjc
寨	jtcd
寢	jvme
寤	jvmr
察	jbof
寮	jkcf
寬	jtbi
審	jhdw
寫	jhxf
寵	jybp
寶	jmuc
寸	di
寺	gdi
封	ggdi
射	hhdi
尉	sfdi
專	jidi
將	vmbdi
尊	twdi
尋	smmri
對	tgdi
導	yudi
小	nc
少	fh
尖	fk
尚	fbr
尤	iku
尬	kuoll
就	yfiku
尷	kusmt
尸	s
尺	so
尼	sp
局	ssr
屁	spp
尿	se
尾	shqu
屈	suu
居	sjr
屆	sug
屎	sfd
屏	stt
屍	smnp
屋	smig
屑	sfb
展	stv
屐	shoe
屠	sjka
屜	shot
屢	sllv
層	scwa
履	shoe
屬	sewi
屯	pu
山	u
屹	uon
岐	uje
岑	uoin
岔	cshu
岌	unhe
岷	urvp
岡	btu
岸	ummj
岩	umr
岫	ulw
岱	opu
岳	omu
峙	ugdi
峭	ufb
峽	ukoo
峻	uice
峪	ucor
峨	uhqi
峰	uhej
島	hayu
崁	ugno
崇	ujmf
崆	ujcm
崎	ukmr
崛	usuu
崖	umgg
崢	ubsd
崑	uapp
崩	ubb
崔	uog
崙	uomb
嵌	utmo
嵐	uhni
嵩	uyrb
嶄	ujjl
嶇	usrr
嶝	unot
嶼	uhxc
嶺	uoic
嶽	ukhk
巍	uhvi
巔	ujcc
巒	vfu
巖	urrk
川	lll
州	ilil
巢	vvwd
工	mlm
巨	ss
巧	mmvs
左	km
巫	moo
差	tqm
己	su
已	su
巳	ru
巴	au
巷	tcru
巽	rutc
巾	lb
市	ylb
布	klb
帆	lbhni
希	kklb
帘	jclb
帚	smblb
帖	lbyr
帕	lbha
帛	halb
帑	velb
帝	yblb
帥	hrlb
席	itlb
師	hrmlb
常	fbrlb
帶	kpblb
帳	lbsmv
帷	lbog
幅	lbmrw
帽	lbabu
幀	lbybc
幌	lbafu
幛	lbytj
幣	fklb
幕	takb
幗	lbwim
幔	lbawe
幢	lbytg
幟	lbyia
幫	gihab
干	mj
平	mfj
并	tt
年	oq
幸	gtj
幹	jjomj
幻	vis
幼	viks
幽	uvii
幾	vihi
序	inin
庇	ipp
床	id
庚	ilo
店	iyr
府	iodi
底	ihpm
庖	ipru
庠	itq
度	ite
庫	ijwj
庭	inkg
座	ioog
康	ile
庸	ilb
庶	itf
庵	iklu
庾	ihxo
廊	iiil
廁	ibcn
廂	idbu
廉	itxc
廈	imue
廓	iydl
廖	ismh
廢	inoe
廚	igti
廟	ijjb
廝	itcl
廣	itmc
廠	ifbk
龐	iybp
廬	iypt
廳	isgp
廷	nkhg
延	nkhym
建	nklq
廿	t
弁	it
弄	mgt
弈	yct
弊	fkt
式	ipm
弒	kcipm
弓	n
弔	nl
引	nl
弘	ni
弗	lln
弛	npd
弟	cnlh
弦	nyvi
弧	nhvo
弩	ven
弭	nsj
弱	nmnim
張	nsmv
強	nili
弼	nman
彆	fkn
彈	nrrj
彌	nmfb
彎	vfn
彗	qjsm
彙	vmbwd
彞	nmfft
彤	byhhh
形	mthhh
彥	ykmhh
彬	ddhh
彩	bdhhh
彫	brhhh
彭	gthhh
彰	yjhhh
影	afhhh
彷	hoyhs
役	hohne
往	hoyg
征	homym
彿	holln
彼	hodhe
很	hoav
待	hogdi
徊	howr
律	holq
徇	hopa
後	hovie
徒	hogyo
徑	homvm
徐	hoomd
得	hoami
徙	hoylo
從	hoooo
徘	holmy
御	hooml
復	hooae
循	hohju
徨	hohag
徬	hoybs
微	houuk
徹	hoybk
德	hojwp
徵	hougk
徽	houfk
心	p
必	ph
忙	pyv
忖	pdi
忘	yvp
忌	sup
志	gp
忍	sip
忱	plbu
快	pdk
忝	hkp
忠	lp
忽	php
念	oinp
忿	cshp
怏	plbk
怔	pmym
怯	pgi
怵	pijc
怖	pklb
怪	peg
怕	pha
怡	pir
性	phqm
怒	vep
思	wp
怠	irp
急	nmp
怎	osp
怨	nup
恍	pfmu
恰	pomr
恨	pav
恢	pkf
恆	pmbm
恃	pgdi
恬	phjr
恫	pbmr
恪	pher
恤	phbt
恙	tgp
恣	mop
恥	sjp
恐	mnp
恕	vrp
恭	tcp
恩	wkp
息	hup
悄	pfb
悟	pmmr
悚	pdl
悍	pamj
悔	powy
悌	pcnh
悅	pcru
悖	pjbd
恿	nbp
患	llp
悉	hdp
悠	okp
您	ofp
惋	pjnu
悴	pyoj
惦	piyr
悽	pjlv
情	pqmb
悻	pgtj
悵	psmv
惜	pta
悼	pyaj
惘	pbtv
惕	paph
惆	pbgr
惟	pog
悸	phdd
惚	pphp
惑	imp
惡	mmp
悲	lyp
悶	anp
惠	jip
愜	psko
愣	pwls
惺	pahm
愕	prrs
惰	pkmb
惻	pbcn
惴	pumb
慨	paiu
惱	pvvw
愎	poae
惶	phag
愉	pomn
愀	phdf
愚	wbp
意	ytap
慈	tvip
感	irp
想	dup
愛	bbpe
惹	tkrp
愁	hfp
愈	ombp
慎	pjbc
慌	ptyu
慄	pmwd
慍	pwot
愾	pond
愴	poir
愧	phui
慇	hep
愿	mfp
態	ipp
慷	pile
慢	pawe
慣	pwjc
慟	phgs
慚	pjjl
慘	piih
慶	ixe
慧	qjsmp
慮	ypwp
慝	srp
慕	takp
憂	mbphe
慼	ifp
慰	sip
慫	hop
慾	cop
憧	pytg
憐	pfdq
憫	pank
憎	pcwa
憬	payf
憚	prrj
憤	pjtc
憔	pogf
憲	jqmp
憑	ifp
憩	hup
憊	obp
懍	pywd
憶	pytp
憾	pirp
懂	pthg
懊	phbk
懈	pnbq
應	iogp
懇	bvp
懦	pmbb
懣	ebp
懲	hkp
懷	pywv
懶	pdlc
懵	ptwu
懸	bfp
懺	poim
懼	pbug
懾	psjj
懿	gtmop
戀	vfp
戈	i
戊	ih
戎	ij
戌	ihm
戍	ihi
成	ihs
戒	it
我	hqi
或	irm
戕	vmi
戚	ihymf
戛	mui
戟	jji
戡	tvi
戢	rji
截	jiog
戮	shi
戰	rji
戲	yti
戴	jiwtc
戳	sgi
戶	hs
房	hsyhs
戾	hsik
所	hshml
扁	hsbt
扇	hssmm
扈	hsrau
扉	hslmy
手	q
才	dh
扎	qu
打	qmn
扔	qnhs
扒	qc
扣	qr
扛	qm
托	qhp
抄	qfh
抗	qyhn
抖	qyj
技	qje
扶	qqo
抉	qdk
扭	qng
把	qau
扼	qmsu
找	qi
批	qpp
扳	qhe
抒	qnin
扯	qylm
折	qhml
扮	qcsh
投	qhne
抓	qhlo
抑	qhvl
承	nnqo
拉	qyt
拌	qfq
拄	qyg
抿	qrvp
拂	qlln
抹	qdj
拒	qss
招	qshr
披	qdhe
拓	qmr
拔	qikk
拋	qkus
拈	qyr
抨	qmfj
抽	qlw
押	qwl
拐	qrsh
拙	quu
拇	qwyi
拍	qha
抵	qhpm
拚	qit
抱	qpru
拘	qpr
拖	qopd
拗	qvis
拆	qhmy
抬	qir
拎	qoii
拜	hqmqj
挖	qjcn
按	qjv
拼	qyjj
拭	qipm
持	qgdi
拮	qgr
拽	qlwp
指	qpa
拱	qtc
拷	qjks
拯	qnem
括	qhjr
拾	qomr
拴	qomg
挑	qlmo
拳	fqq
挈	qhq
拿	orq
捎	qfb
挾	qkoo
振	qmmv
捕	qijb
捂	qmmr
捆	qwd
捏	qag
捏	qhxg
捉	qryo
挺	qnkg
捐	qrb
挽	qnau
挪	qsql
挫	qoog
挨	qiok
掠	qyrf
控	qjcm
捲	qfqu
掖	qyok
探	qbcd
接	qytv
捷	qjlo
捧	qqkq
掘	qsuu
措	qta
捱	qmgg
掩	qklu
掉	qyaj
掃	qsmb
掛	qggy
捫	qan
推	qog
掄	qomb
授	qbbe
掙	qbsd
採	qbd
掬	qpfd
排	qlmy
掏	qpou
掀	qhlo
捻	qoip
捩	qhsk
捨	qomr
掣	hnq
掌	fbrq
描	qtw
揀	qdwf
揩	qppa
揉	qnhd
揆	qnok
揍	qqkk
插	qhjx
揣	qumb
提	qamo
握	qsmg
揖	qrsj
揭	qapv
揮	qbjj
捶	qhjm
援	qbme
揪	qhdf
換	qnbk
摒	qsyj
揚	qamh
搓	qtqm
搾	qjcs
搞	qyrb
搪	qilr
搭	qtor
搽	qtod
搬	qhye
搏	qibi
搜	qhxe
搔	qeii
損	qrbc
搶	qoir
搖	qbou
搗	qhau
撇	qfbk
摘	qycb
摔	qyij
撤	qybk
摸	qtak
摟	qllv
摺	qsma
摑	qwim
摧	quog
摩	icq
摯	giq
摹	takq
撞	qytg
撲	qtco
撈	qffs
撐	qfbh
撰	qruc
撥	qnoe
撓	qggu
撕	qtcl
撩	qkcf
撒	qtbk
撮	qase
播	qhdw
撫	qotf
撚	qbkf
撬	qhuu
擅	qywm
擁	qyvg
擋	qfbw
撻	qygq
撼	qirp
據	qypo
擄	qyps
擇	qwlj
擂	qmbw
操	qrrd
撿	qomo
擒	qoyb
擔	qncr
擎	tkq
擊	jeq
擘	sjq
擠	qyx
擰	qjpn
擦	qjbf
擬	qpko
擱	qanr
擴	qitc
擲	qtkl
擾	qmbe
攆	qqoj
擺	qwlp
擻	qlvk
攀	ddkq
攏	qybp
攘	qyrv
攔	qanw
攙	qnri
攝	qsjj
攜	quob
攤	qtog
攣	vfq
攫	qbue
攪	qhbu
攬	qswu
支	je
收	vlok
改	suok
攻	mok
放	ysok
政	mmok
故	jrok
效	ykok
敝	fbok
敖	gsok
救	ieok
教	jdok
敗	bcok
啟	hrok
敏	oyok
敘	odok
敞	fbok
敦	ydok
敢	mjok
散	tbok
敬	trok
敲	ybye
敵	ybok
敷	isok
數	lvok
整	dkmym
斂	oook
斃	fkmnp
文	yk
斑	mgykg
斐	lyyk
斗	yj
料	fdyj
斜	odyj
斟	tvyj
斡	jjoyj
斤	hml
斥	hmy
斧	ckhml
斫	mrhml
斬	jjhml
斯	tchml
新	ydhml
斷	vihml
方	yhs
於	ysoy
施	ysopd
旁	ybyhs
旅	ysohv
族	ysook
旋	ysono
旌	ysohm
旎	ysosp
旗	ysotc
旖	ysokr
既	aimvu
日	a
旦	am
早	aj
旨	pa
旬	pa
旭	kna
旱	amj
旺	amg
昔	ta
易	aphh
昌	aa
昆	app
昂	ahvl
明	ab
昀	apmm
昏	hpa
春	qka
昭	ashr
映	albk
昧	ajd
是	amyo
星	ahqm
昨	aos
時	agdi
晉	miia
晏	ajv
晃	afmu
晒	amcw
晌	ahbr
晝	lgam
晚	anau
晤	ammr
晨	ammv
晦	aowy
普	tca
晰	adhl
晴	aqmb
晶	aaa
景	ayrf
暑	ajka
智	ora
暗	ayta
暉	abjj
暇	arse
暈	abjj
暖	abme
暢	llamh
暨	auam
暮	taka
暫	jla
暴	atce
曆	mhda
曉	aggu
暹	yaog
曙	awla
曖	abbe
曠	aitc
曝	aate
曦	atgs
曰	a
曲	tw
曳	lwp
更	mlwk
曷	apvo
書	lga
曹	twa
勗	abms
曾	cwa
替	qoa
會	omwa
月	b
有	kb
服	bsle
朋	bb
朔	tub
朕	btk
朗	iib
望	ybhg
期	tcb
朝	jjb
朦	btbo
朧	bybp
木	d
朮	ijc
本	dm
未	jd
末	dj
札	du
朽	dmvs
朴	dy
朱	hjd
朵	hnd
束	dl
李	dnd
杏	dr
材	ddh
村	ddi
杜	dg
杖	djk
杞	dsu
杉	dhhh
杭	dyhn
枋	dyhs
枕	dlbu
東	dw
果	wd
杳	da
杷	dau
枇	dpp
枝	dje
林	dd
杯	dmf
杰	df
板	dhe
枉	dmg
松	dci
析	dhml
杵	doj
枚	dok
柿	dylb
染	end
柱	dyg
柔	nhd
某	tmd
柬	dwf
架	krd
枯	djr
柵	dbt
柩	dsno
柯	dmnr
柄	dmob
柑	dtm
枴	drsh
柚	dlw
查	dam
枸	dpr
柏	dha
柞	dos
柳	dhhl
校	dyck
核	dyvo
案	jvd
框	dsmg
桓	dmam
根	dav
桂	dgg
桔	dgr
栩	dsmm
梳	dyiu
栗	mwd
桌	yad
桑	eeed
栽	jid
柴	ypd
桐	dbmr
桀	nqd
格	dher
桃	dlmo
株	dhjd
桅	dnmu
栓	domg
梁	eid
梯	dcnh
梢	dfb
梓	dytj
梵	ddhni
桿	damj
桶	dnib
梱	dwd
梧	dmmr
梗	dmlk
械	dit
梃	dnkg
棄	yitd
梭	dice
梆	dqjl
梅	dowy
梔	dhmu
條	olod
梨	hnd
梟	hayd
棺	djrr
棕	djmf
棠	fbrd
棘	dbdb
棗	dbdb
椅	dkmr
棟	ddw
棵	dwd
森	ddd
棧	dii
棹	dyaj
棒	dqkq
棲	djlv
棣	dle
棋	dtmc
棍	dapp
植	djbm
椒	dyfe
椎	dog
棉	dhab
棚	dbb
榔	diil
業	tctd
楚	ddnyo
楷	dppa
楠	djbj
楔	dqhk
極	dmem
椰	dsjl
概	daiu
楊	damh
楨	dybc
楫	drsj
楞	dwls
楓	dhni
楹	dnst
榆	domn
榜	dybs
榨	djcs
榕	djcr
槁	dyrb
榮	ffbd
槓	dmbc
構	dttb
榛	dqkd
榷	dobg
榻	dasm
榫	dogj
榴	dhhw
槐	dhui
槍	doir
榭	dhhi
槌	dyhr
樣	dtge
樟	dytj
槨	dydl
樁	dqkx
樞	dsrr
標	dmwf
槽	dtwa
模	dtak
樓	dllv
樊	ddk
槳	vid
樂	vid
樅	dhoo
樽	dtwi
樸	dtco
樺	dtmj
橙	dnot
橫	dtmc
橘	dnhb
樹	dgti
橄	dmjk
橢	dnlb
橡	dnao
橋	dhkb
橇	dhuu
樵	dogf
機	dvii
檀	dywm
檔	dfbw
檄	dhsk
檢	domo
檜	doma
櫛	dhal
檳	djmc
檬	dtbo
櫃	dslc
檻	dsmt
檸	djpn
櫂	dsmg
櫥	digi
櫝	dgwc
櫚	danr
櫓	dnwa
櫻	dbcv
欄	danw
權	dtrg
欖	dswu
欠	no
次	mmno
欣	hlno
欲	crno
款	gfno
欺	tcno
欽	cno
歇	avno
歉	tcno
歌	mrno
歐	srno
歙	omno
歟	hcno
歡	tgno
止	ylm
正	mylm
此	ymp
步	ylmh
武	mpylm
歧	ymje
歪	mfmym
歲	ymihh
歷	mhdm
歸	hmsmb
歹	mni
死	mnp
歿	mnne
殃	mnlbk
殆	mnir
殊	mnhjd
殉	mnpa
殘	mnii
殖	mnjbm
殤	mnoah
殮	mnomo
殯	mnjmc
殲	mnoim
段	hjhne
殷	hshne
殺	kchne
殼	gnhne
毀	hghne
殿	schne
毅	yohne
毆	srhne
毋	wjh
母	wyi
每	owyi
毒	qmwyi
毓	oyyiu
比	pp
毗	wpp
毛	hqu
毫	yrbu
毯	huff
毽	hunkq
氏	hvp
民	rvp
氐	hpm
氓	yvrvp
氖	onnhs
氛	oncsh
氟	onlln
氣	onfd
氧	ontq
氨	onjv
氦	onyvo
氤	onwk
氫	onmvm
氮	onff
氯	onvne
氳	onwot
水	e
永	ine
汁	ej
汀	emn
氾	esu
求	ije
汝	ev
汗	emj
汙	emd
江	em
池	epd
汐	eni
汕	eu
汞	me
沙	efh
沁	ep
沈	elbu
沉	ebhu
沅	emmu
沛	eylb
汪	emg
決	edk
沐	ed
汰	eki
沌	epu
汨	ea
沖	el
沒	ene
汽	eomn
沃	ehk
汲	enhe
汾	ecsh
泣	eyt
注	eyg
泳	eine
沱	ejp
泌	eph
泥	esp
河	emnr
沽	ejr
沾	eyr
沼	eshr
波	edhe
沫	edj
法	egi
泓	eni
沸	elln
泄	ept
油	elw
況	erhu
沮	ebm
泗	ewc
泅	ewo
泱	elbk
沿	ecr
治	eir
泡	epru
泛	ehio
泊	eha
泉	hae
泰	qke
洋	etq
洲	eill
洪	etc
流	eyiu
津	elq
洌	emnn
洱	esj
洞	ebmr
洗	ehgu
活	ehjr
洽	eomr
派	ehhv
洶	epuk
洛	eher
浪	eiav
涕	ecnh
消	efb
涇	emvm
浦	eijb
浸	esme
海	eowy
浙	eqhl
涓	erb
浬	ewg
涉	eylh
浮	ebnd
浚	eice
浴	ecor
浩	ehgr
涎	enkm
涼	eyrf
淳	eyrd
淙	ejmf
液	eyok
淡	eff
淌	efbr
淤	eysy
添	ehkp
淺	eii
清	eqmb
淇	etmc
淋	edd
涯	emgg
淑	eyfe
涮	esbn
淞	edci
淹	eklu
涸	ewjr
混	eapp
淵	elxl
淅	edhl
淒	ejlv
渚	ejka
涵	eune
淚	ehsk
淫	ebhg
淘	epou
淪	eomb
深	ebcd
淮	eog
淨	ebsd
淆	ekkb
淄	evvw
港	etcu
游	eysd
湔	etbn
渡	eite
渲	ejmm
湧	enbs
湊	eqkk
渠	esd
渥	esmg
渣	edam
減	eihr
湛	etmv
湘	edbu
渤	ejds
湖	ejrb
湮	emwg
渭	ewb
渦	ebbr
湯	eamh
渴	eapv
湍	eumb
渺	ebuh
測	ebcn
湃	ehqj
渝	eomn
渾	ebjj
滋	etvi
溉	eaiu
渙	enbk
溢	etct
溯	etub
滓	ejyj
溶	ejcr
滂	eybs
源	emhf
溝	ettb
滇	ejbc
滅	eihf
溥	eibi
溘	egit
溼	emvg
溺	enmm
溫	ewot
滑	ebbb
準	egj
溜	ehhw
滄	eoir
滔	ebhx
溪	ebvk
漳	eytj
演	ejmc
滾	eycv
漓	eyub
滴	eycb
漩	eyso
漾	etge
漠	etak
漬	eqmc
漏	esmb
漂	emwf
漢	etlo
滿	etlb
滯	ekpb
漆	edoe
漱	edlo
漸	ejjl
漲	ensv
漣	eyjj
漕	etwa
漫	eawe
漯	ewvf
澈	eybk
漪	ekhr
滬	ehsu
漁	enwf
滲	eiih
滌	eold
漿	vie
潼	eytg
澄	enot
潑	enoe
潦	ekcf
潔	eqhf
澆	eggu
潭	emwj
潛	emua
潸	eddb
潮	ejjb
澎	egth
潺	esnd
潰	elmc
潤	eang
澗	eana
潘	ehdw
濂	eitc
澱	esce
澡	errd
濃	etwv
澤	ewlj
濁	ewli
澧	etwt
澳	ehbk
激	ehsk
澹	encr
濘	ejpn
濱	ejmc
濟	eyx
濠	eyro
濛	etbo
濤	egni
濫	esmt
濯	esmg
澀	esim
濬	eybu
濡	embb
瀉	ejhf
瀋	ejhw
濾	eypp
瀆	egwc
濺	ebci
瀑	eate
瀏	ehcn
瀛	eynv
瀟	etlx
瀨	edlc
瀚	ejjm
瀝	emhm
瀕	eyhc
瀾	eanw
瀰	enmb
灌	etrg
灑	emmp
灘	etog
灣	evfn
灤	evfd
火	f
灰	kf
灶	fg
灼	fpm
災	vvf
灸	nof
炕	fyhn
炎	ff
炒	ffh
炊	fno
炙	bf
炫	fyvi
為	iknf
炳	fmob
炬	fss
炯	fbr
炭	umf
炸	fos
炮	fpru
烊	ftq
烘	ftc
烤	fjks
烙	fher
烈	mnf
烏	hryf
烹	yrnf
焉	mylf
焊	famj
烽	fhej
焙	fytr
焚	ddf
焦	ogf
焰	fnhx
無	otf
然	bkf
煮	jaf
煎	tbnf
煙	fmwg
煩	fmbc
煤	ftmd
煉	fdwf
照	arf
煜	fayt
煬	famh
煦	arf
煌	fhag
煥	fnbk
煞	nkf
熔	fjcr
熙	suf
煽	fhsm
熊	ipf
熄	fhup
熟	yif
熬	gkf
熱	gif
熨	sif
熾	fyia
燉	fydk
燐	ffdq
燒	fggu
燈	fnot
燕	tlpf
熹	grtf
燎	fkcf
燙	ehf
燜	fanp
燃	fbkf
燄	nxff
燧	fyto
營	ffbrr
燮	ffe
燦	fyed
燥	frrd
燭	fwli
燬	fhge
燴	foma
燻	fhgf
爆	fate
爍	fvid
爐	fypt
爛	fanw
爨	hbddf
爪	hlo
爬	hoau
爭	bsd
爰	bmke
爵	bwli
父	ck
爸	ckau
爹	cknin
爺	cksjl
爻	kk
爽	kkkk
爾	mfbk
牆	vmgow
片	llml
版	llhe
牌	llhwj
牒	llptd
牖	llhsb
牘	llgwc
牙	mvdh
牛	hq
牟	ihq
牝	hqp
牢	jhq
牡	hqg
牠	hqpd
牧	hqok
物	hqphh
牲	hqhqm
牯	hqjr
牴	hqhpm
特	hqgdi
牽	yvbq
犁	hnhq
犄	hqkmr
犀	sehq
犒	hqyrb
犖	ffbhq
犛	jkmhq
犢	hqgwc
犧	hqtgs
犬	ik
犯	khsu
狄	khf
狂	khmg
狀	vmik
狎	khwl
狙	khbm
狗	khpr
狐	khhvo
狩	khjdi
狠	khav
狡	khyck
狼	khiav
狹	khkoo
狽	khbuc
狸	khwg
狷	khrb
猜	khqmb
猛	khndt
猖	khaa
猓	khwd
猙	khbsd
猶	khtcw
猥	khwmv
猴	khonk
猩	khahm
猷	twik
獅	khhrb
猿	khgrv
猾	khbbb
獄	khyrk
獐	khytj
獎	viik
獗	khmto
獨	khwli
獰	khjpn
獲	khtoe
獷	khitc
獵	khvvv
獸	rrik
獺	khdlc
獻	ybik
玀	khwlg
玄	yvi
率	yioj
王	mg
玉	mgi
玖	mgno
玩	mgmmu
玨	mgmg
玟	mgyk
玫	mgok
玷	mgyr
珊	mgbt
玻	mgdhe
玲	mgoii
珍	mgohh
珀	mgha
玳	mgoip
班	mgilg
琉	mgyiu
珮	mghnb
珠	mghjd
琅	mgiav
琊	mgmhl
球	mgije
理	mgwg
現	mgbuu
琍	mghdn
琺	mgegi
琪	mgtmc
琳	mgdd
琢	mgmso
琥	mgypu
琵	mgpp
琶	mgau
琴	mgoin
瑯	mgiil
瑚	mgjrb
瑕	mgrse
瑟	mgph
瑞	mgumb
瑁	mgabu
琿	mgbjj
瑙	mgvvw
瑛	mgtlk
瑜	mgomn
瑤	mgbou
瑣	mgfbc
瑪	mgsqf
瑰	mghui
瑩	ffbmi
璋	mgytj
璃	mgyub
璜	mgtlc
璣	mgvii
璩	mgypo
環	mgwlv
璦	mgbbe
璧	sjmgi
璽	mbmgi
瓊	mgnbe
瓏	mgybp
瓜	hvio
瓠	kshvo
瓢	mfhvo
瓣	yjhoj
瓦	mvni
瓶	ttmvn
瓷	momvn
甄	mgmvn
甌	srmvn
甕	yvgn
甘	tm
甚	tmmv
甜	hrtm
生	hqm
產	ykmhm
甥	hmwks
甦	mkhqm
用	bq
甩	bqu
甬	nibq
甫	ijb
甭	mfbq
田	w
由	lw
甲	wl
申	lwl
男	wks
甸	pw
甽	wlll
畏	wmv
界	woll
畔	wfq
畝	ywno
畜	yviw
畚	ikw
留	hhw
略	wher
畦	wgg
畢	wtj
異	wtc
畫	lgwm
番	hdw
當	fbrw
畸	wkmr
疇	wgni
疆	ngmwm
疊	wwwm
疋	nyo
疏	nmyiu
疑	pknio
疝	ku
疙	kon
疚	kno
疫	khne
疤	kau
疥	koll
疾	kok
病	kmob
症	kmym
疲	kdhe
疳	ktm
疽	kbm
疼	khey
疹	kohh
痊	komg
痔	kgdi
痕	kav
疵	kymp
痢	khdn
痛	knib
痣	kgp
痙	kmvm
痘	kmrt
痞	kmfr
瘀	kysy
痰	kff
瘁	kyoj
痲	kjcc
痱	klmy
痺	khwj
痿	khdv
痴	kokr
瘧	kypm
瘍	kamh
瘋	khni
瘉	komn
瘓	knbk
瘠	kfcb
瘩	ktor
瘟	kwot
瘤	khhw
瘦	khxe
瘡	koir
瘴	kytj
瘸	kkrb
癆	kffs
療	kkcf
癌	krru
癖	ksrj
癘	ktwb
癒	komp
癢	ktov
癥	khok
癩	kdlc
癮	knlp
癬	knfq
癱	ktog
癲	kjcc
癸	nomk
登	nomrt
發	nonhe
白	ha
百	ma
皂	hap
的	hapi
皆	ppha
皇	hamg
皈	hahe
皎	hayck
皖	hajmu
皓	hahgr
皚	haumt
皮	dhe
皰	depru
皴	iedhe
皺	pudhe
皿	bt
盂	mdbt
盈	nsbt
盆	csht
盃	mfbt
益	tcbt
盍	gibt
盎	lkbt
盔	kfbt
盒	orbt
盛	isbt
盜	eobt
盞	iibt
盟	abbt
盡	lmfbt
監	smbt
盤	hebt
盧	ypwbt
盥	hxbt
盪	ehbt
目	bu
盯	bumn
盲	yvbu
直	jbmm
省	fhbu
盹	bupu
相	dbu
眉	ahbu
看	hqbu
盾	hjbu
盼	bucsh
眩	buyvi
真	jbmc
眠	burvp
眨	buhio
眷	fqbu
眾	wlooo
眼	buav
眶	busmg
眸	buihq
眺	bulmo
睏	buwd
睛	buqmb
睫	bujlo
睦	bugcg
睞	budoo
督	yebu
睹	bujka
睪	wlgtj
睬	bubd
睜	bubsd
睥	buhwj
睨	buhxu
瞄	butw
睽	bunok
睿	ybmcu
睡	buhjm
瞎	bujqr
瞇	buyfd
瞌	bugit
瞑	bubac
瞠	bufbg
瞞	butlb
瞟	bumwf
瞥	fkbu
瞳	buytg
瞪	bunot
瞰	bumjk
瞬	bubbq
瞧	buogf
瞭	bukcf
瞽	gebu
瞿	buog
瞻	buncr
矇	butbo
矓	buybp
矗	jmjmm
矚	busei
矛	ninh
矜	nhoin
矢	ok
矣	iok
知	okr
矩	okss
短	okmrt
矮	okhdv
矯	okhkb
石	mr
矽	mrni
砂	mrfh
研	mrmt
砌	mrpsh
砍	mrno
砰	mrmfj
砧	mryr
砸	mrslb
砝	mrgi
破	mrdhe
砷	mrlwl
砥	mrhpm
砭	mrhio
硫	mryiu
硃	mrhjd
硝	mrfb
硬	mrmlk
硯	mrbuu
碎	mryoj
碰	mrttc
碗	mrjnu
碘	mrtbc
碌	mrvne
碉	mrbgr
硼	mrbb
碑	mrhwj
磁	mrtvi
碟	mrptd
碧	mamr
碳	mrumf
碩	mrmbc
磋	mrtqm
磅	mrybs
確	mrobg
磊	mrmrr
碾	mrstv
磕	mrgit
碼	mrsqf
磐	hemr
磨	icmr
磚	mrjii
磬	gemr
磷	mrfdq
磺	mrtlc
磴	mrnot
磯	mrvii
礁	mrogf
礎	mrddo
礙	mrpko
礦	mritc
礪	mrmtb
礬	ddkmr
礫	mrvid
示	mmf
社	ifg
祀	ifru
祁	ifnl
祆	ifmk
祉	ifylm
祈	ifhml
祇	ifhvp
祕	ifph
祐	ifkr
祠	ifsmr
祟	uummf
祖	ifbm
神	iflwl
祝	ifrhu
祗	ifhpm
祚	ifos
祥	iftq
票	mwmmf
祭	bommf
祺	iftmc
祿	ifvne
禁	ddmmf
禎	ifybc
福	ifmrw
禍	ifbbr
禦	hlmmf
禧	ifgrr
禪	ifrrj
禮	iftwt
禱	ifgni
禹	hlbi
萬	twlb
禽	oyub
禾	hd
私	hdi
秀	hdnhs
禿	hdhu
秉	hdl
科	hdyj
秒	hdfh
秋	hdf
秤	hdmfj
秣	hddj
秧	hdlbk
租	hdbm
秦	qkhd
秩	hdhqo
移	hdnin
稍	hdfb
稈	hdamj
程	hdrhg
稅	hdcru
稀	hdkkb
稜	hdgce
稚	hdog
稠	hdbgr
稔	hdoip
稟	ywrd
種	hdhjg
稱	hdbgb
稿	hdyrb
稼	hdjmo
穀	gdhne
稽	hdiua
稷	hdwce
稻	hdbhx
積	hdqmc
穎	pdmbc
穆	hdhah
穌	nfhd
穗	hdjip
穡	hdgow
穢	hdymh
穫	hdtoe
穩	hdbmp
穴	jc
究	jckn
空	jcm
穹	jcn
穿	jcmvh
突	jcik
窄	jcos
窈	jcvis
窒	jcmig
窕	jclmo
窘	jcskr
窗	jchwk
窖	jchgr
窟	jcsuu
窠	jcwd
窪	jcegg
窩	jcbbr
窯	jctgf
窮	jchhn
窺	jcqou
竄	jchxv
竅	jchsk
竇	jcgwc
竊	jchdb
立	yt
站	ytyr
童	ytwg
竣	ytice
竭	ytapv
端	ytumb
競	yuytu
竹	h
竺	hmm
竿	hmj
竽	hmd
笆	hau
笑	hhk
笠	hyt
笨	hdm
笛	hlw
第	hnlh
符	hodi
笙	hhqm
笞	hir
等	hgdi
策	hdb
筆	hlq
筐	hsmg
筒	hbmr
答	homr
筍	hpa
筋	hbks
筏	hoi
筷	hpdk
節	hail
筠	hgpm
管	hjrr
箕	htmc
箋	hii
筵	hnkm
算	hbut
箝	hqtm
箔	heha
箏	hbsd
箭	htbn
箱	hdbu
範	hjju
箴	hihr
篆	hvno
篇	hhsb
篁	hhag
篙	hyrb
簑	hywv
築	hmnd
篤	hsqf
篛	hnmm
篡	hbui
篩	hhrb
簇	hysk
簍	hllv
篾	hwli
篷	hyhj
簫	hlx
簧	htlc
簪	hmua
簞	hrrj
簣	hlmc
簡	hana
簾	hitc
簿	heii
簸	htce
簽	homo
簷	hncr
籌	hgni
籃	hsmt
籍	hqda
籐	hbfe
籠	hybp
籟	hdlc
籤	hoim
籬	hybg
籮	hwlg
籲	hobc
米	fd
粉	fdcsh
粒	fdyt
粗	fdbm
粟	mwfd
粥	nfdn
粱	eifd
粳	fdmlk
粵	hwmvs
粹	fdyoj
粽	fdjmf
精	fdqmb
糊	fdjrb
糕	fdtgf
糖	fdilr
糠	fdile
糜	icfd
糞	fdwtc
糢	fdtak
糟	fdtwa
糙	fdyhr
糧	fdamg
糯	fdmbb
糸	vif
系	hvif
糾	vfvl
紂	vfdi
紅	vfm
紀	vfsu
紉	vfshi
紇	vfon
約	vfpm
紡	vfyhs
紗	vffh
紋	vfyk
紊	ykvif
素	qmvif
索	jbvif
純	vfpu
紐	vfng
紕	vfpp
級	vfnhe
紜	vfmmi
納	vfob
紙	vfhvp
紛	vfcsh
絆	vffq
絃	vfyvi
統	vfyiu
紮	duvif
紹	vfshr
紼	vflln
絀	vfuu
細	vfw
紳	vflwl
組	vfbm
累	wvif
終	vfhey
絞	vfyck
結	vfgr
絨	vfij
絕	vfshu
紫	ypvif
絮	vrvif
絲	vfvif
絡	vfher
給	vfomr
絢	vfpa
經	vfmvm
絹	vfrb
綑	vfwd
綁	vfqjl
綏	vfbv
綻	vfjmo
綰	vfjrr
綜	vfjmf
綽	vfyaj
綾	vfgce
綠	vfvne
緊	sevif
綴	vfeee
網	vfbtv
綱	vfbtu
綺	vfkmr
綢	vfbgr
綿	vfhab
綵	vfbd
綸	vfomb
維	vfog
緒	vfjka
緇	vfvvw
締	vfybb
練	vfdwf
緯	vfdmq
緻	vfmgk
緘	vfihr
緬	vfmwl
緝	vfrsj
編	vfhsb
緣	vfvno
線	vfhae
緞	vfhje
緩	vfbme
綞	vfhjm
縊	vftct
縑	vftxc
縈	ffbvf
縛	vfibi
縣	bfhvf
縮	vfjoa
績	vfqmc
繆	vfsmh
縷	vfllv
縲	vfwvf
繃	vfubb
縫	vfyhj
總	vfhwp
縱	vfhoo
繅	vfvvd
繁	okvif
織	vfyia
繕	vftgr
繞	vfggu
繚	vfkcf
繡	vflx
繫	jevif
繭	tbli
繹	vfwlj
繩	vfrxu
繪	vfoma
辮	yjvfj
繽	vfjmc
繼	vfvvi
纂	hbuf
纏	vfiwg
續	vfgwc
纓	vfbcv
纖	vfoim
纜	vfswu
缶	oju
缸	oum
缺	oudk
缽	oudm
罄	geoju
罈	oumwj
罐	outrg
罕	bcmj
罔	btyv
罟	wljr
置	wljbm
罩	wlyaj
罪	wllmy
署	wljka
罰	wlyrn
罵	wlsqf
罷	wlibp
罹	wlpog
羅	wlvfg
羈	wltjf
羊	tq
羌	tghu
羋	tlq
美	tgk
羔	tgf
羞	tqng
羚	tqoii
善	tgtr
義	tghqi
羨	tgeno
群	srtq
羯	tqapv
羲	tghds
羶	tqywm
羹	tgftk
羸	yntq
羽	smsim
羿	smt
翅	jesmm
翁	cism
翌	smyt
翎	oismm
習	smha
翔	tqsmm
翕	orsmm
翠	smyoj
翡	lysmm
翟	smog
翩	hbsmm
翰	jjosm
翱	hjsmm
翳	sesmm
翼	smwtc
翹	gusmm
翻	hwsmm
耀	fusmg
老	jkp
考	jkys
者	jka
耆	jpa
而	mbll
耐	mbdi
耍	mbv
耒	qd
耘	qdmmi
耕	qdtt
耙	qdau
耗	qdhqu
耜	qdrlr
耳	sj
耶	sjnl
耽	sjlbu
耿	sjf
聊	sjhhl
聆	sjoii
聖	srhg
聘	sjlws
聞	ansj
聚	seooo
聱	gksj
聲	gesj
聰	sjhwp
聯	sjvit
聳	hosj
職	sjyia
聶	sjsjj
聾	ypsj
聽	sgjwp
聿	lq
肆	silq
肄	pklq
肅	lx
肇	hklq
肉	obo
肋	bks
肌	bhn
肖	fb
肓	yvb
肝	bmj
肘	bdi
肛	bm
肚	bg
育	yib
肺	bylb
肥	bau
肢	bje
肱	bki
股	bhne
肫	bpu
肩	hsb
肴	kkb
肪	byhs
肯	ymb
胖	bfq
胥	nob
胚	bmfm
胃	wb
胄	lwb
背	lpb
胡	jrb
胛	bwl
胎	bir
胞	bpru
胤	lvbu
胱	bfmu
脂	bpa
胰	bkn
脅	ksksb
胭	bwk
胴	bbmr
脆	bnmu
胸	bpuk
胳	bher
脈	bhhv
能	ibpp
脊	fcb
脯	bijb
脖	bjbd
脣	mvb
脫	bcru
脩	olob
腕	bjnu
腔	bjcm
腋	byok
腑	bioi
腎	seb
脹	bsmv
腆	btbc
脾	bhwj
腐	ioib
腱	bnkq
腰	bmwv
腸	bamh
腥	bahm
腮	bwp
腳	bcrl
腫	bhjg
腹	boae
腺	bhae
腦	bvvw
膀	bybs
膏	yrbb
膈	bmrb
膊	bibi
腿	byav
膛	bfbg
膜	btak
膝	bdoe
膠	bsmh
膚	ypwb
膳	btgr
膩	bipc
膨	bgth
臆	bytp
臃	byvg
膺	iogb
臂	sjb
臀	seb
膿	btwv
膽	bncr
臉	bomo
膾	boma
臍	byx
臏	bjmc
臘	bvvv
臚	bypt
臟	btis
臣	slsl
臥	slo
臧	imsll
臨	slorr
自	hbu
臭	huik
臬	hud
至	mig
致	mgok
臺	grbg
臻	mgqkd
臼	hx
臾	hxo
舀	bhx
舂	qkhx
舅	hxwks
與	hxyc
興	hxbc
舉	hcq
舊	togx
舌	hjr
舍	omjr
舐	hrhvp
舒	ornin
舔	hrhkp
舛	niq
舜	bbnq
舞	otniq
舟	hbyi
舢	hyu
航	hyyhn
舫	hyyhs
舨	hyhe
般	hyhne
舵	hyjp
舷	hyyvi
舶	hyha
船	hycr
艇	hynkg
艘	hyhxe
艙	hyoir
艦	hysmt
艮	av
良	iav
艱	toav
色	nau
艾	tk
芒	tyv
芋	tmd
芍	tpm
芳	tyhs
芝	tino
芙	tqo
芭	tau
芽	tmvh
芟	thne
芹	thml
花	top
芬	tcsh
芥	toll
芻	pupu
苧	tjmn
范	tesu
茅	tnih
苣	tss
苛	tmnr
苦	tjr
茄	tksr
若	tkr
茂	tih
茉	tdj
苒	tgb
苗	tw
英	tlbk
茁	tuu
苜	tbu
苔	tir
苑	tniu
苞	tpru
苓	toii
苟	tpr
茫	teyv
荒	tyvu
荔	tkss
荊	tmtn
茸	tsj
荐	tkld
草	taj
茵	twk
茴	twr
荏	tohg
茲	tvii
茹	tvr
茶	tod
茗	tnir
荀	tpa
茱	thjd
莎	tefh
莞	tjmu
莘	tytj
荸	tjbd
莢	tkoo
莖	tmvm
莽	tikt
莫	tak
莒	trhr
莊	tvmg
莓	towy
莉	thdn
莠	thds
荷	tomr
荻	tkhf
荼	tomd
菩	tytr
萃	tyoj
菸	tysy
萍	temj
菠	tede
菅	tjrr
萋	tjlv
菁	tqmb
華	tmtj
菱	tgce
菴	tklu
著	tjka
萊	tdoo
菰	tndo
萌	tab
菌	twhd
菽	tyfe
菲	tlmy
菊	tpfd
萸	thxo
萎	thdv
萄	tpou
菜	tbd
蒂	tybb
葷	tbjj
落	tehr
萱	tjmm
葵	tnok
葦	tdmq
葫	tjrb
葉	tptd
葬	tmpt
葛	tapv
萼	trrs
萵	tbbr
葡	tpib
董	thjg
葩	thau
蓉	tjcr
蒿	tyrb
蓆	titb
蓄	tyvw
蒙	tbmo
蒞	teot
蒲	teib
蒜	tmff
蓋	tgit
蒸	tnef
蓀	tndf
蓓	toyr
蒐	thui
蒼	toir
蔗	titf
蔽	tfbk
蔚	tsfi
蓮	tyjj
蔬	tnmu
蔭	tnli
蔓	tawe
蔑	twli
蔣	tvmi
蔡	tbof
蔔	tpmw
蓬	tyhj
蔥	thwp
蓿	tjoa
蕊	tppp
蕙	tjip
蕈	tmwj
蕨	tmto
蕩	teah
蕃	thdw
蕉	togf
蕭	tlx
蕪	totf
薪	tydl
薄	teii
蕾	tmbw
薜	tsrj
薑	tmwm
薔	tgow
薯	twla
薛	thrj
薇	thok
藏	tims
薩	tnlm
藍	tsmt
藐	tbhu
藉	tqda
薰	thgf
藩	tehw
藝	tgii
藪	tlvk
藕	tqdb
藤	tbfe
藥	tvid
藻	terd
藹	tyrv
蘑	ticr
藺	tang
蘆	typt
蘋	tyhc
蘇	tnfd
蘊	tvft
蘗	tsjd
蘭	tanw
蘚	tnfq
蘸	tmgf
蘿	twlg
虎	yphu
虐	ypsm
虔	ypyk
處	yphen
彪	yuhhh
虛	yptm
虜	ypwks
虞	yprvk
號	rsypu
虧	ygmms
虫	lmi
虱	nhli
虹	lim
蚊	liyk
蚪	liyj
蚓	linl
蚤	eilmi
蚩	umli
蚌	liqj
蚣	lici
蛇	lijp
蛀	liyg
蚶	litm
蛄	lijr
蚵	limnr
蛆	libm
蛋	nolmi
蚱	lios
蚯	liom
蛟	liyck
蛙	ligg
蛭	limig
蛔	liwr
蛛	lihjd
蛤	liomr
蛹	linib
蜓	linkg
蜈	lirvk
蜇	qllmi
蜀	wlpli
蛾	lihqi
蛻	licru
蜂	lihej
蜃	mvlmi
蜿	lijnu
蜜	jphi
蜻	liqmb
蜢	lindt
蜥	lidhl
蜴	liaph
蜘	liokr
蝕	oilmi
螂	liiil
蝴	lijrb
蝶	liptd
蝠	limrw
蝦	lirse
蝸	libbr
蝨	njlii
蝙	lihsb
蝗	lihag
蝌	lihdj
螃	liybs
螟	libac
螞	lisqf
螢	ffbli
融	mblmi
蟀	liyij
蟑	liytj
螳	lifbg
蟒	litit
蟆	litak
螫	gklmi
螻	lillv
螺	liwvf
蟈	liwim
蟋	lihdp
蟯	liggu
蟬	lirrj
蟲	lilii
蟻	litgi
蠅	lirxu
蠍	liavo
蟹	nqlmi
蠔	liyro
蠕	limbb
蠣	limtb
蠢	qalii
蠡	volii
蠟	livvv
蠱	lilit
蠶	muali
蠹	jbmri
蠻	vflmi
血	hbt
行	hommn
衍	hoemn
術	hoicn
街	hoggn
衙	homrn
衛	hodqn
衝	hohgn
衡	honkn
衢	hobgn
衣	yhv
初	lsh
表	qmv
衫	lhhh
衰	ywmv
衷	jlhv
袁	grhv
袂	ldk
袞	ycrhv
袈	kryhv
被	ldhe
袒	lam
袖	llw
袍	lpru
袋	opyhv
裁	jiyhv
裂	mnyhv
袱	loik
裟	ehyhv
裔	yvbcr
裙	lskr
補	lijb
裘	ieyhv
裝	vgyhv
裡	lwg
裊	hayv
裕	lcor
裳	fbryv
褂	lggy
裴	lyyhv
裹	ywdv
裸	lwd
製	hnyhv
裨	lhwj
褚	ljka
褐	lapv
複	loae
褒	yodv
褓	lord
褪	lyav
褲	lijj
褥	lmvi
褫	lhyu
褻	ygiv
褶	lsma
襄	yrrv
褸	lllv
襠	lfbw
襟	lddf
襖	lhbk
襤	lsmt
襪	ltwi
襲	ypyhv
襯	lydu
西	mcw
要	mwv
覃	mwaj
覆	mwhoe
見	buhu
覓	bbuu
規	qobuu
視	ifbuu
親	ydbuu
覦	onbuu
覬	utbuu
覲	tmbuu
覺	hbbuu
覽	swbuu
觀	tgbuu
角	nbg
解	nbshq
觴	nboah
觸	nbwli
言	ymmr
計	yrj
訂	yrmn
訃	yry
記	yrsu
訐	yrmj
討	yrdi
訌	yrm
訕	yru
訊	yrnj
託	yrhp
訓	yrlll
訖	yron
訪	yryhs
訝	yrmvh
訣	yrdk
訥	yrob
許	yroj
設	yrhne
訟	yrci
訛	yrop
註	yryg
詠	yrine
評	yrmfj
詞	yrsmr
証	yrmym
詁	yrjr
詔	yrshr
詛	yrbm
詐	yros
詆	yrhpm
訴	yrhmy
診	yrohh
詫	yrjhp
該	yryvo
詳	yrtq
試	yripm
詩	yrgdi
詰	yrgr
誇	yrkms
詼	yrkf
詣	yrpa
誠	yrihs
話	yrhjr
誅	yrhjd
詭	yrnmu
詢	yrpa
詮	yromg
詬	yrhmr
詹	ncymr
誦	yrnib
誌	yrgp
語	yrmmr
誣	yrmoo
認	yrsip
誡	yrit
誓	qlymr
誤	yrrvk
說	yrcru
誥	yrhgr
誨	yrowy
誘	yrhds
誑	yrkhg
誼	yrjbm
諒	yryrf
談	yrff
諄	yryrd
誕	yrnkm
請	yrqmb
諸	yrjka
課	yrwd
諉	yrhdv
諂	yrnhx
調	yrbgr
誰	yrog
論	yromb
諍	yrbsd
諦	yrybb
諺	yrykh
諫	yrdwf
諱	yrdmq
謀	yrtmd
諜	yrptd
諧	yrppa
諮	yrmor
諾	yrtkr
謁	yrapv
謂	yrwb
諷	yrhni
諭	yromn
謎	yryfd
謗	yrybs
謙	yrtxc
講	yrttb
謊	yrtyu
謠	yrbou
謝	yrhhi
謄	bfqr
謨	yrtak
謹	yrtlm
謬	yrsmh
譁	yrtmj
譜	yrtca
識	yryia
證	yrnot
譚	yrmwj
譎	yrnhb
譏	yrvii
議	yrtgi
譬	sjymr
警	tkymr
譯	yrwlj
譴	yrylr
護	yrtoe
譽	hcymr
讀	yrgwc
變	vfok
讓	yryrv
讒	yrnri
讖	yroim
讚	yrhuc
谷	cor
豁	jrcor
谿	bkcor
豆	mrt
豈	umrt
豉	mtje
豌	mtjnu
豎	semrt
豐	ujmrt
豔	utgit
豕	msho
豚	bmso
象	napo
豢	fqmso
豪	yrbo
豬	mojka
豫	nnnao
豺	bhdh
豹	bhpi
貂	bhshr
貊	bhma
貉	bhher
貍	bhwg
貌	bhhau
貓	bhtw
貝	buc
貞	ybuc
負	nbuc
財	bcdh
貢	mbuc
販	bche
責	qmbuc
貫	wjbuc
貨	opbuc
貪	oinc
貧	cshc
貯	bcjmn
貼	bcyr
貳	ipmmc
貽	bcir
賁	jtbc
費	lnbuc
賀	krbuc
貴	lmbuc
買	wlbuc
貶	bchio
貿	hhbuc
貸	opbuc
賊	bcij
資	mobuc
賈	mwbuc
賄	bckb
貲	ypbuc
賃	ogbuc
賂	bcher
賅	bcyvo
賓	jmhc
賑	bcmmv
賒	bcomf
賠	bcytr
賞	fbrbc
賦	bcmpm
賤	bcii
賬	bcsmv
賭	bcjka
賢	sebuc
賣	gwlc
賜	bcaph
質	hlbuc
賴	dlshc
賺	bctxc
賽	jtcc
購	bcttb
贅	gkbuc
贈	bccwa
贊	hubuc
贏	ynbuc
贍	bcncr
贓	bcims
贖	bcgwc
贗	mofc
贛	yjhec
赤	glnc
赧	gcsle
赦	gcok
赫	gcglc
赭	gcjka
走	gyo
赴	goy
赳	govl
起	goru
越	goiv
超	goshr
趁	goohh
趙	gofb
趕	goamj
趟	gofbr
趣	gosje
趨	gopuu
足	ryo
趴	rmc
趾	rmylm
跎	rmjp
距	rmss
跋	rmikk
跚	rmbt
跑	rmpru
跌	rmhqo
跛	rmdhe
跆	rmir
跡	rmylc
跟	rmav
跨	rmkms
路	rmher
跳	rmlmo
跺	rmhnd
跪	rmnmu
跼	rmssr
踫	rmttc
踐	rmii
踝	rmwd
踢	rmaph
踏	rmea
踩	rmbd
踟	rmokr
蹄	rmybb
踱	rmite
踴	rmnbs
蹂	rmnhd
踹	rmumb
踵	rmhjg
蹉	rmtqm
蹋	rmasm
蹈	rmbhx
蹊	rmbvk
蹙	ifryo
蹣	rmtlb
蹦	rmubb
蹤	rmhoo
蹼	rmtco
蹲	rmtwi
躇	rmtja
蹶	rmmto
蹬	rmnot
蹺	rmggu
躉	twbo
躁	rmrrd
躅	rmwli
躂	rmygq
躊	rmgni
躍	rmsmg
躑	rmtkl
躡	rmsjj
躪	rmtag
身	hxh
躬	hhn
躲	hhhnd
躺	hhfbr
軀	hhsrr
車	jwj
軋	jju
軍	bjwj
軌	jjkn
軒	jjmj
軔	jjshi
軛	jjmsu
軟	jjno
軻	jjmnr
軸	jjlw
軼	jjhqo
較	jjyck
載	jijwj
軾	jjipm
輊	jjmig
輔	jjijb
輒	jjsju
輕	jjmvm
輓	jjnau
輝	fubjj
輛	jjmlb
輟	jjeee
輩	lyjwj
輦	qojwj
輪	jjomb
輜	jjvvw
輻	jjmrw
輯	jjrsj
輸	jjomn
轄	jjjqr
輾	jjstv
轂	gjhne
轅	jjgrv
輿	hxjc
轉	jjjii
轍	jjybk
轔	jjfdq
轎	jjhkb
轟	jjjjj
轡	vfr
辛	ytj
辜	jrytj
辟	srytj
辣	yjdl
辨	yjilj
辦	yjksj
辭	bbytj
辯	yjyrj
辰	mmmv
辱	mvdi
農	twmmv
迂	ymd
迆	ypd
迅	ynj
迄	yon
巡	yvvv
迎	yhvl
返	yhe
近	yhml
述	yijc
迦	yksr
迢	yshr
迪	ylw
迥	ybr
迭	yhqo
迫	yha
送	ytk
逆	ytu
迷	yfd
退	yav
迺	ymcw
迴	ywr
逃	ylmo
追	yhrr
逅	yhmr
這	yymr
逍	yfb
通	ynib
逗	ymrt
連	yjwj
速	ydl
逝	yqhl
逐	ymso
逕	ymvm
逞	yrhg
造	yhgr
透	yhds
逢	yhej
逖	ykhf
逛	ykhg
途	yomd
逮	yle
逵	ygcg
週	ybgr
逸	ynai
進	yog
運	ybjj
遊	yysd
道	ythu
遂	ytpo
達	ygtq
逼	ymrw
違	ydmq
遐	yrse
遇	ywlb
遏	yapv
過	ybbr
遍	yhsb
遑	yhag
逾	yomn
遁	yhju
遠	ygrv
遘	yttb
遜	yndf
遣	ylmr
遙	ybou
遞	yhyu
適	yycb
遮	yitf
遨	ygsk
遭	ytwa
遷	ymwu
遵	ytwi
遴	yfdq
選	yruc
遲	yseq
遼	ykcf
遺	ylmc
避	ysrj
遽	yypo
還	ywlv
邁	ytwb
邂	ynbq
邀	yhsk
邇	ymfb
邊	yhus
邐	ymmp
邏	ywlg
邑	rau
邕	vvrau
邢	mtnl
邪	mhnl
邦	qjnl
那	sqnl
邵	srnl
邸	hmnl
邱	omnl
郊	yknl
郎	iinl
郁	kbnl
郡	srnl
部	yrnl
郭	ydnl
都	janl
鄂	rsnl
郵	hmnl
鄉	vhiil
鄒	punl
鄙	rwnl
鄰	fqnl
鄭	tknl
鄧	ntnl
鄱	hwnl
鄹	sonl
酉	mcwm
酋	tcwm
酊	mwmn
酒	emcw
配	mwsu
酌	mwpm
酗	mwuk
酣	mwtm
酥	mwhd
酬	mwill
酪	mwher
酩	mwnir
酵	mwjkd
酸	mwice
酷	mwhgr
醇	mwyrd
醉	mwyoj
醋	mwta
醃	mwklu
醒	mwahm
醣	mwilr
醞	mwwot
醜	mwhui
醫	semcw
醬	vimcw
醺	mwhgf
釀	mwyrv
釁	hbmch
采	bd
釉	bdlw
釋	hdwlj
里	wg
重	hjwg
野	wgnin
量	amwg
釐	jkmwg
金	c
釘	cmn
針	cj
釗	cln
釜	ckmgc
釵	cei
釦	cr
釣	cpi
釧	clll
鈔	cfh
鈣	cmys
鈕	cng
鈉	cob
鈞	cpmm
鈍	cpu
鈐	coin
鈷	cjr
鉗	ctm
鈸	cikk
鈽	cklb
鉀	cwl
鈾	clw
鉛	ccr
鉋	cpru
鉤	cpr
鉑	cha
鈴	coii
鉸	cyck
銬	cjks
銀	cav
銅	cbmr
銘	cnir
銖	chjd
鉻	cher
銓	comg
銜	hocmn
鋅	cytj
銻	ccnh
銷	cfb
鋪	cijb
鋤	cbms
鋁	crhr
銳	ccru
銼	coog
鋒	chej
錠	cjmo
錶	cqmv
鋸	csjr
錳	cndt
錯	cta
錢	cii
鋼	cbtu
錫	caph
錄	cvne
錚	cbsd
錐	cog
錦	chab
鍍	cite
鎂	ctgk
錨	ctw
鍵	cnkq
鍊	cdwf
鍥	cqhk
鍋	cbbr
錘	chjm
鍾	chjg
鍬	chdf
鍛	chje
鍰	cbme
鎔	cjcr
鎊	cybs
鎖	cfbc
鎢	chrf
鎳	chud
鎮	cjbc
鏡	cytu
鏑	cycb
鏟	cykm
鏃	cysk
鏈	cyjj
鏜	cfbg
鏝	cawe
鏖	ipc
鏢	cmwf
鏍	cwvf
鏘	cvmi
鏤	cllv
鏗	cseg
鐘	cytg
鐃	cggu
鏽	clx
鐮	citc
鐳	cmbw
鐵	cjig
鐺	cfbw
鐸	cwlj
鐲	cwli
鑄	cgni
鑑	csmt
鑒	swc
鑣	cipf
鑠	cvid
鑲	cyrv
鑰	comb
鑽	chuc
鑾	vfc
鑼	cwlg
鑿	tec
長	smv
門	an
閂	anm
閃	ano
閉	andh
閔	anyk
閏	anmg
開	anmt
閑	and
間	ana
閒	anb
閘	anwl
閡	anyvo
閨	angg
閩	anlmi
閣	anher
閥	anoi
閤	anomr
閭	anrhr
閱	ancru
閻	annhx
闊	anehr
闋	annok
闌	andwf
闈	andmq
闆	anrrr
闔	angit
闖	ansqf
闐	anjbc
關	anvit
闡	anrrj
闢	ansrj
阜	hrj
阡	nlhj
防	nlyhs
阮	nlmmu
阱	nltt
阪	nlhe
陀	nljp
阿	nlmnr
阻	nlbm
附	nlodi
限	nlav
陋	nlmbv
陌	nlma
降	nlheq
院	nljmu
陣	nljwj
陡	nlgyo
陛	nlppg
陝	nlkoo
除	nlomd
陪	nlytr
陵	nlgce
陳	nldw
陸	nlgcg
陰	nloii
陴	nlhwj
陶	nlpou
陷	nlnhx
隊	nltpo
階	nlppa
隋	nlkmb
陽	nlamh
隅	nlwlb
隆	nlhem
隍	nlhag
陲	nlhjm
隘	nltct
隔	nlmrb
隕	nlrbc
隙	nlfhf
障	nlytj
際	nlbof
隧	nlyto
隨	nlykb
險	nlomo
隱	nlbmp
隴	nlybp
隸	dfle
隻	oge
雀	fog
雁	moog
雅	mhog
雄	kiog
雋	oglms
集	ogd
雇	hsog
雍	yvhg
雉	okog
雌	ympog
雕	brog
雖	riog
雜	ydog
雙	oge
雛	puog
雞	bkog
離	ybog
難	toog
雨	mlby
雪	mbsm
雯	mbyk
雲	mbmmi
雷	mbw
電	mbwu
雹	mbpru
零	mboii
需	mbmbl
霄	mbfb
霆	mbnkg
震	mbmmv
霉	mbowy
霎	mbytv
霑	mbeyr
霖	mbdd
霍	mbog
霓	mbhxu
霏	mblmy
霜	mbdbu
霞	mbrse
霪	mbebg
霧	mbnhs
霸	mbtjb
霹	mbsrj
露	mbrmr
霽	mbyx
霾	mbbhg
靂	mbmhm
靈	mbrro
靄	mbyrv
青	qmb
靖	ytqmb
靛	qbjmo
靜	qbbsd
非	lmsy
靠	hgrly
靡	iclmy
面	mwsl
靦	mwbuu
靨	mkmwl
革	tlj
靴	tjop
靶	tjau
靼	tjam
鞅	tjlbk
鞍	tjjv
鞋	tjgg
鞏	mntlj
鞘	tjfb
鞠	tjpfd
鞣	tjnhd
鞦	tjhdf
鞭	tjomk
韃	tjygq
韁	tjmwm
韆	tjymu
韋	dmrq
韌	dqshi
韓	jjdmq
韜	dqbhx
韭	lsmm
音	yta
章	ytaj
竟	ytahu
韶	yashr
韻	yarbc
響	vlyta
頁	mbuc
頂	mnmbc
頃	pmbc
項	mmbc
順	lllc
須	hhmbc
預	nnmbc
頑	mumbc
頓	pumbc
頊	mgmbc
頒	chmbc
頌	cimbc
頗	dembc
領	oimbc
頡	grmbc
頰	kombc
頸	mmmbc
頻	yhmbc
頷	ormbc
頭	mtmbc
頹	humbc
頤	slmbc
顆	wdmbc
額	jrmbc
顏	yhmbc
題	aombc
顎	rsmbc
顓	ubmbc
類	fkmbc
願	mfmbc
顛	jcmbc
顧	hgmbc
顫	ymmbc
顯	afmbc
顰	ychwj
顱	ytmbc
風	hnmli
颯	ythni
颱	hnir
颳	hnhjr
颶	hnbmc
颺	hnamh
颼	hnhxe
飄	mfhni
飛	nohto
食	oiav
飢	oihn
飧	nioiv
飪	oihg
飯	oihe
飩	oipu
飲	oino
飭	oioks
飼	oismr
飴	oiir
飽	oipru
飾	oiolb
餃	oiyck
餅	oitt
餌	oisj
餉	oihbr
養	toiav
餓	oihqi
餒	oibv
餘	oiomd
餐	yeoiv
館	oijrr
餞	oiii
餛	oiapp
餡	oinhx
餵	oiwmv
餾	oihhw
餿	oihxe
餽	oihui
饅	oiawe
饒	oiggu
饑	oivii
饜	mkoiv
饞	oinri
首	thbu
香	hda
馥	haoae
馨	gehda
馬	sqsf
馮	imsqf
馭	sfe
馳	sfpd
馱	sfk
馴	sflll
駁	sfkk
駝	sfjp
駐	sfyg
駟	sfwc
駛	sflk
駑	vesqf
駕	krsqf
駒	sfpr
駙	sfodi
駭	sfyvo
駢	sftt
駱	sfher
騁	sflws
駿	sfice
騎	sfkmr
騖	nksqf
騙	sfhsb
騫	jtcf
騰	bfqf
騷	sfeii
驅	sfsrr
驃	sfmwf
驀	takf
騾	sfwvf
驕	sfhkb
驚	tksqf
驛	sfwlj
驗	sfomo
驟	sfseo
驢	sfypt
驥	sflpc
驪	sfmmp
骨	bbb
骯	bbyhn
骰	bbhne
骷	bbjr
骸	bbyvo
骼	bbher
髏	bbllv
髒	bbtmt
髓	bbykb
體	bbtwt
高	yrbr
髦	shhqu
髮	shikk
髯	shgb
髻	shgr
髭	shymp
鬃	shjmf
鬆	shdci
鬍	shjrb
鬚	shhhc
鬢	shjmc
鬥	ln
鬧	lnylb
鬨	lntc
鬱	ddbuh
鬲	mrbl
鬼	hui
魁	hiyj
魂	mihui
魅	hijd
魄	hahui
魏	hvhui
魔	ichui
魘	mkhui
魚	nwf
魷	nfiku
魯	nwfa
鮑	nfpru
鮮	nftq
鮫	nfyck
鮪	nfkb
鯊	ehnwf
鯉	nfwg
鯽	nfail
鯨	nfyrf
鯧	nfaa
鰓	nfwp
鰍	nfhdf
鰭	nfjpa
鰥	nfwle
鱉	fknwf
鰱	nfyjj
鰾	nfmwf
鰻	nfawe
鱔	nftgr
鱗	nffdq
鱖	nfmto
鱷	nfmgr
鱸	nfypt
鳥	hayf
鳩	knhaf
鳴	rhaf
鳶	iphaf
鳳	hnmaf
鴆	luhaf
鴉	mhhaf
鴕	hfjp
鴣	jrhaf
鴦	lkhaf
鴨	wlhaf
鴒	oihaf
鴛	nuhaf
鴻	emhf
鴿	orhaf
鵑	rbhaf
鵝	hihaf
鵠	hrhaf
鶉	ydhaf
鵡	mmhaf
鵲	tahaf
鵪	kuhaf
鵬	bbhf
鶯	ffbhf
鶴	jghaf
鷂	buhaf
鷓	ifhaf
鷗	srhaf
鷥	vfhaf
鷹	iogf
鷺	rrhaf
鸚	bvhaf
鸞	vfhaf
鹹	ywihr
鹼	ywomo
鹽	swbt
鹿	ixp
麂	iphn
麋	ipfd
麒	iptmc
麗	mmbbp
麓	ddixp
麝	iphhi
麟	ipfdq
麥	johe
麩	jeqo
麴	jepfd
麵	jemwl
麻	ijcc
麼	icvi
麾	ichqu
黃	tmlc
黍	hdoe
黎	hhoe
黏	heyr
黑	wgf
墨	wgfg
默	wfik
黔	wfoin
點	wfyr
黜	wfuu
黝	wfvis
黛	opwgf
黠	wfgr
黨	fbrwf
黯	wfyta
黴	houfk
黷	wfgwc
鼇	gkrxu
鼎	buvml
鼓	gtje
鼕	gehey
鼙	gehwj
鼠	hxvyv
鼬	hvlw
鼴	hvsav
鼻	huwml
鼾	hlmj
齊	yx
齋	yxf
齒	ymuoo
齟	yubm
齣	yupr
齡	yuoii
齜	yuymp
齦	yuav
齬	yummr
齪	yuryo
齷	yusmg
齲	yuhlb
龍	ybysp
龔	yptc
龜	nxu
万	ms
丌	ml
丏	mlvs
冇	kb
与	ysm
丮	nq
丰	qj
丱	vlllm
乂	k
乜	pn
亍	mmn
亓	mml
亢	yhn
亳	yrbp
亶	ywrm
亹	yhbm
仂	oks
仉	ohn
仨	ommm
仜	om
仩	oym
仡	oon
仝	om
伎	oje
优	oiku
伬	oso
仵	ooj
伔	obhu
伋	onhe
仱	ooin
伀	oci
价	ooll
佖	oph
伻	omfj
佢	oss
佉	ogi
体	odm
佤	omvn
伾	omfm
佈	oklb
佧	oymy
佒	olbk
佚	ohqo
佟	ohey
佁	oir
佘	ommf
侘	ojhp
佼	oyck
侅	oyvo
佽	ommo
侀	omtn
侇	okn
佶	ogr
佴	osj
侉	okms
侑	okb
侄	omig
佷	oav
佌	oymp
侗	obmr
佪	owr
侚	opa
佹	onmu
侁	ohgu
佸	ohjr
侐	ohbt
侜	ohby
佺	oomg
侔	oihq
侞	ovr
俍	oiav
俅	oije
俓	omvm
侲	ommv
俉	ommr
侷	ossr
俋	orau
俁	orvk
俔	obuu
俜	olws
俙	okkb
侻	ocru
侳	ooog
俛	onau
俇	okhg
倞	oyrf
倅	oyoj
倇	ojnu
倓	off
倢	ojlo
倰	ogce
倛	otmc
俵	oqmv
俴	oii
倳	ojln
倷	okmf
倬	oyaj
俶	oyfe
俷	obau
倗	obb
倜	obgr
倠	oog
偯	oyrv
偰	oqhk
偪	omrw
偡	otmv
偞	optd
偠	omwv
偭	omwl
偓	osmg
偋	ostt
偝	olpb
偲	owp
偈	oapv
偍	oamo
偁	obgb
偛	ohjx
偊	ohlb
偢	ohdf
倕	ohjm
偅	ohjg
偟	ohag
偩	onbc
偫	ohoi
傛	ojcr
傚	oykk
傕	oobg
傔	otxc
傞	otqm
傋	ottb
傣	oqke
傃	oqmf
傌	osqf
傎	ojbc
傝	oasm
偨	oypd
傜	obou
傒	obvk
傂	ohyu
傽	oytj
傿	omyf
僆	oyjj
傮	otwa
僄	omwf
僊	omwu
傴	osrr
僇	osmh
僈	oawe
僂	ollv
傰	oubb
僁	ohdp
傺	obof
傱	ohoo
僋	ooic
僉	omro
僦	oyfu
僔	otwi
僗	offs
僨	ojtc
僳	omwd
僛	otco
僪	onhb
僎	oruc
僝	osnd
僤	orrj
僓	olmc
僩	oanb
僬	oogf
僰	dbo
僿	ojtg
儃	oywm
儰	otif
僸	oddf
儆	otrk
儇	owlv
僶	orxu
僾	obbe
儋	oncr
儌	ohsk
僽	ohfp
儜	ojpn
儕	oyx
儓	ogrg
儗	opko
儚	otwn
儑	oavf
儦	oipf
儥	ogwc
儢	oypp
儤	oate
儠	ovvv
儱	oybp
儴	oyrv
儵	olof
儳	onri
儺	otog
儸	owlg
儹	ohuc
儻	ofbf
儽	owwf
党	fbrhu
冏	bcr
冔	armd
冓	ttgb
冘	lbu
冞	bfd
冪	btab
冱	immvm
冼	imhgu
凊	imqmb
凄	imjlv
凅	imwjr
凔	imoir
凘	imtcl
刌	diln
刉	onln
刓	muln
刖	bln
刜	lnln
刞	bmln
刵	sjln
刲	ggln
刳	ksln
剆	iiln
刱	ttshi
剄	mmln
剉	ogln
剡	ffln
剚	jnln
剒	taln
剞	krln
剟	eeeen
剕	lmsyn
剫	ieln
剭	sgln
剬	ubln
剺	jkmsh
剸	jiln
剻	ubln
剼	ihln
劂	moln
劀	nbln
劁	ofln
劋	rdln
劌	yhln
劊	oaln
劓	hlln
劖	niln
劘	iyln
劗	hcln
劙	viln
劦	kskss
劭	srks
劼	grks
勍	yfks
勖	auks
勣	qcks
勩	pcks
勰	kswp
勱	tbks
勴	ypks
勺	pm
匊	pfd
匜	spd
匢	sphh
匭	sjjn
匰	srrj
匴	shbt
匷	sbug
匼	somr
匽	sav
卌	tt
卍	nx
卣	yws
卬	hvsl
卼	munmu
厂	mh
厎	mhpm
厒	moju
厗	mytj
厖	miuh
厞	mlmy
厜	mhjm
厤	mhdd
厬	mahr
厹	kni
叄	iiim
叡	yue
叻	rks
吰	rki
吷	rdk
吪	rop
呔	rki
听	rhml
咇	rph
呿	rgi
咁	rtm
咑	rqmn
咂	rslb
咈	rlln
呫	ryr
呺	rrms
呾	ram
呥	rgb
呬	rwc
呴	rpr
呦	rvis
咍	rir
咩	rtq
咺	rmam
咡	rsj
咭	rgr
咥	rmig
咧	rmnn
哏	rav
哃	rbmr
茍	tpr
咷	rlmo
咮	rhjd
哖	roq
咶	rhjr
哅	rpuk
哆	rnin
咿	rosk
咠	rsj
呰	ypr
咼	bbr
咢	rrmms
唦	refh
唇	mvr
哢	rmgt
唗	rgyo
唒	rmcw
哧	rglc
哳	rqhl
哽	rmlk
哤	riuh
唚	rsme
哿	krmnr
唄	rbuc
唈	rrau
哫	rryo
唏	rkkb
唑	roog
唅	roir
啵	rede
啶	rjmo
唼	rytv
啍	ryrd
啐	ryoj
唴	rtgu
唪	rqkq
啑	rjlo
啢	rmlb
唶	rta
唵	rklu
唰	rsbn
啒	rsuu
啅	ryaj
啁	rbgr
啗	rnhx
唌	rnkm
唲	rhxu
啥	romr
啎	ojmmr
喑	ryta
喨	ryru
喥	rite
喭	rykh
啷	riil
噅	rikf
喢	rhjx
喫	rqhk
喓	rmwv
喈	rppa
喏	rtkr
喵	rtw
喁	rwlb
喙	rvno
喣	rrf
喒	rhoa
喤	rhag
啽	rort
喌	rrill
喦	rrru
嗃	ryrb
嗛	rtxc
嗌	rtct
嗐	rjqr
嗉	rqmf
嗋	rksb
嗊	rmbc
嗝	rmrb
嗀	grhne
嗔	rjbc
嗄	rmue
嗩	rfbc
喿	rrrd
嗒	rtor
喍	rypd
嗏	rtod
嗕	rmvi
嗢	rwot
嗖	rhxe
嗈	rvvu
嗲	rckn
嘧	rjpu
嘕	rmyf
嘌	rmwf
嘒	rqjm
嗼	rtak
嘏	jrrse
嘜	rjon
嘁	rihf
嘐	rsmh
嘓	rwim
嗶	rwtj
嘂	rrvlr
嗺	ruog
嘝	rnbj
嘄	rhad
嗿	roic
噈	ryfu
噂	rtwi
噌	rcwa
嘵	rggu
噁	rmmp
噊	rnhb
噉	rmjk
噆	rmua
噘	rmto
噚	rsmi
噀	rruc
嘳	rlmc
嘽	rrrj
嘬	rase
嘾	rmwj
嘸	rotf
噍	rogf
噰	ryvg
噠	rygq
噶	rtav
噮	rwlv
噳	rypk
噦	rymh
噣	rwli
噭	rhsk
噲	roma
噞	romo
嚓	rjbf
嚌	ryx
嚍	rlmt
嚆	rtyb
嚄	rtoe
嚃	rywe
嚘	rmbe
嚜	rwgg
嚗	rate
嚚	rrslr
嚫	rydu
嚭	grmfr
嚦	rmhm
嚧	rypt
嚪	ranx
嚬	ryhc
嚲	ydrrj
嚵	rnri
嚳	hbhgr
囃	rydg
嚽	rgkc
嚾	rtrg
囆	rtwi
囅	rjstv
囋	rhuc
囓	rqhu
囍	grgrr
囔	rjbv
囗	bm
囝	wnd
囡	wv
囟	hwk
囫	wphh
囮	wop
囧	wcb
囷	whd
囹	woii
囿	wkb
圁	wymr
圄	wmmr
圂	wmso
圊	wqmb
圉	wgtj
圇	womb
圌	wumb
圜	wwlv
圞	wvfd
圠	gu
圩	gmd
圮	gsu
坁	ghvp
圻	ghml
坅	goin
坌	cshg
坯	gmfm
坲	glln
坭	gsp
坫	gyr
坱	glbk
坰	gbr
坶	gwyi
垀	ghfd
坵	gom
坻	ghpm
坳	gvis
坴	gcg
垵	gjv
垞	gjhp
垓	gyvo
垟	gtq
垤	gmig
垌	gbmr
垗	glmo
垝	gnmu
垛	ghnd
垔	mwg
垘	goik
埌	giav
堲	alg
埕	grhg
埒	gbdi
垺	gbnd
埆	gnbg
垽	elg
垼	heg
埻	gyrd
埢	gfqu
埶	ggkni
埜	ddg
埴	gjbm
堀	gsuu
埭	gle
埽	gsmb
堈	gbtu
埸	gaph
堋	gbb
埳	gnhx
埏	gnkm
堇	tlqm
堩	gpmm
堷	gyta
堙	gmwg
堞	gptd
堧	gmbk
堝	gbbr
堣	gwlb
堨	gapv
埵	ghjm
堠	gonk
塈	aug
堥	nkg
塓	gbac
塨	gtcp
塤	grbc
塒	gagi
塏	gumt
塍	bfqg
塉	gfcb
塯	ghhw
塕	gcim
塋	ffbg
墉	gilb
塼	gjii
墐	gtlm
墘	gjjn
墆	gkpb
墁	gawe
塿	gllv
塴	gubb
墋	giih
塺	idg
墩	gydk
墫	gtwi
墝	gggu
墱	gnot
墠	grrj
墣	gtco
墦	ghdw
墯	pbg
墬	nog
壈	gywd
墽	ghsk
壖	gmbb
壎	ghgf
壚	gypt
壝	gylc
壛	ganx
壴	grt
壼	gbmm
壾	gtss
壿	gtwi
夃	nshe
夃	nhse
夆	heqj
夌	gche
复	oahe
夎	ooge
夎	oghe
夒	mche
夗	nisu
夬	dk
夯	kks
奅	khhl
奓	knin
奊	ggvk
奡	mukll
奫	kell
奭	kmaa
奰	wlwwk
奲	karrj
妀	suv
奼	vhp
妦	vqj
妘	vmmi
妠	vob
妗	voin
妎	voll
妢	vcsh
妐	vci
妵	vyg
妺	vdj
姏	vtm
姎	vlbk
妲	vam
姌	vgb
姁	vpr
㚷	vof
姡	vhjr
姞	vgr
姮	vmam
娀	vij
姱	vkms
姝	vhjd
姺	vhgu
姽	vnmu
姼	vnin
姶	vomr
姤	vhmr
娙	vmvm
娖	vryo
娉	vlws
娭	viok
婠	vjrr
婘	vfqu
婕	vjlo
婧	vqmb
婞	vgtj
娸	vtmc
娵	vsje
婭	vmlm
婐	vwd
婟	vwjr
婥	vyaj
婬	vbhg
婓	lyv
婤	vbgr
婗	vhxu
媯	vikf
媔	vmwl
媟	vptd
婺	nkv
媢	vabu
媞	vamo
婸	vamh
媦	vwb
媧	vbbr
婼	vtkr
媥	vhsb
媬	vord
媕	vort
媮	vomn
娷	vhjm
嫇	vbac
嫄	vmhf
嫋	vnmm
媺	vuuk
媸	vumi
媱	vbou
媵	bfqv
媰	vpuu
媿	vhui
嫈	ffbv
媻	hev
嫜	vytj
嫮	vmbs
嫥	vjii
嫕	vskp
嫪	vsmh
嫚	vawe
嫭	vypd
嫫	vtak
嫳	fkv
嫢	quv
嫠	jkmv
嫛	sev
嫿	vlgm
嬈	vggu
嫴	vjrj
嫽	vkcf
嫷	vnlb
嫶	vogf
嬃	hcv
嬗	vywm
嬙	vgow
嬛	vwlv
嬡	vbbe
嬎	vnum
嬓	vhsk
嬐	vomo
嬖	sjv
嬭	vmfb
嬥	vsmg
嬲	wsvws
嬽	vwlk
嬽	vwsk
嬾	vdlc
嬿	vtlf
孃	vyrv
孅	voim
孈	vuob
孋	vmmp
孌	vfv
孛	jbnd
孢	ndpru
孥	vend
孬	mfvnd
屘	sund
孲	ndmlm
孷	jkmnd
宁	jmn
宄	jkn
宎	jhk
宓	jph
宕	jmr
宨	jlmo
宧	jsll
寁	jjlo
寀	jbd
寪	jikf
寍	jpbt
寋	jtcu
寔	jamo
寑	jose
寖	jese
寘	jjbc
寙	jhoo
寠	jllv
寰	jwlv
寱	jvmd
尃	ibdi
尌	gtdi
尐	fo
尔	nf
尒	of
尟	aofh
尨	iuhhh
尪	kumg
尰	kuhjg
尳	kubbb
尻	skn
屄	sjc
屌	srlb
屖	sytj
屔	omsp
屙	snlr
屝	slmy
屣	shoo
屧	shod
屨	shov
屩	shob
屭	sbcc
屮	ul
屴	uks
屼	umu
屺	usu
岍	umt
岏	ummu
岈	umvh
岋	unhe
岉	uphh
岒	uoin
岊	auu
岮	ujp
岤	ujc
岠	uss
岵	ujr
岯	umfm
岨	ubm
岬	uwl
岟	ulbk
岣	upr
岭	uoii
岢	umnr
岪	ulln
岧	ushr
岝	uos
峐	uyvo
峘	umam
峌	umig
峒	ubmr
峗	unmu
峋	upa
峛	umnn
峞	unmu
峚	ukg
峉	uher
峇	uomr
峊	hru
峬	uijb
峴	ubuu
峿	ummr
峮	uskr
峱	khngu
峷	uytj
崞	uyrd
崋	umtj
崝	uqmb
崚	ugce
崠	udw
崌	usjr
崨	ujlo
崍	udoo
崦	uklu
崤	ukkb
崥	uhwj
崏	uhpa
崰	uvvw
崒	uyoj
崧	udci
崗	ubtu
崣	uhdv
崟	uc
崷	utcw
嵃	uykh
嵫	utvi
嵁	utmv
嵋	uahu
崿	urrs
崵	uamh
嵑	uapv
嵎	uwlb
嵕	uuce
崳	uomn
崺	uysd
崴	uihv
嵒	rrru
崽	uwp
崱	ubcn
嵙	uhdj
嵇	hdiuu
嵂	uhoq
嵯	utqm
嵱	ujcr
嵣	uilr
嵊	uhdp
嵥	unqd
嵲	uhud
嵬	uhui
嵞	omdu
嶂	uytj
嶀	umbs
嵽	ukpb
嶆	utwa
嵺	usmh
嶁	ullv
嵷	uhoo
嶊	uqog
嶉	urog
嶈	uvmi
嵾	uiih
嶙	ufdq
嶗	uffs
嶟	utwi
嶒	ucwa
嶢	uggu
嶓	uhdw
嶕	uogf
嶠	uhkb
嶜	umua
嶡	umto
嶚	ukcf
嶞	nbu
嶔	ucno
嶬	utgi
嶱	utav
嶩	utwv
嶧	uwlj
嶵	uwly
嶰	unbq
嶮	uomo
嶪	utcd
嶨	hbu
嶲	uogs
嶭	uhrj
嶸	uffd
嶷	upko
巀	ufgi
巃	uybp
巆	uffr
巇	uyti
巉	unri
巏	utrg
巋	uhmb
巕	uthv
巕	utjv
巑	uhuc
巘	uybk
巟	yvhlu
巰	mmyiu
巹	nemsu
巿	jb
帊	lbau
帗	lbikk
帔	lbdhe
帙	lbhqo
帡	lbtt
帢	lbomr
帟	yclb
帣	fqlb
帠	hxlb
帤	vrlb
帩	lbfb
帨	lbcru
帾	lbjka
帴	lbii
幄	lbsmg
幃	lbdmq
幏	lbjmo
幎	lbbac
幘	lbqmc
幙	lbtak
幓	lbiih
幩	lbjtc
幝	lbrrj
幡	lbhdw
幠	lbotf
幧	lbrrd
幨	lbncr
幦	sjlb
幬	lbgni
幪	lbtbo
幭	lbtwi
幰	lbjqp
幵	mjmj
庀	ip
庂	io
庋	ije
庉	ipu
庌	imvh
庈	ioin
庰	itt
庤	igdi
庢	imig
庛	iymp
庣	ilmo
庥	iod
庨	ijkd
庮	imcw
庪	iqje
庬	iiuh
庱	igce
庴	ita
庹	itso
庲	idoo
庳	ihwj
廄	iaie
廅	igit
廌	ixf
廆	ihui
廋	ihxe
廇	ihhw
廘	iixp
廑	itlm
廗	ikpb
廎	ipmc
廜	isja
廕	inli
廙	iwtc
緳	iqhf
廛	iwcg
廞	icno
廡	iotf
廩	iywd
廧	igow
廦	isrj
廨	inbq
廥	ioma
廮	ibcv
廯	infq
廱	ivug
蠯	ihji
廾	jj
异	sut
弅	csht
弇	ort
弋	ip
弚	cnl
弝	nau
弨	nshr
弢	nue
弣	nodi
弤	nhpm
弮	fqn
弳	nmvm
弶	nyrf
弸	nbb
彀	gnhne
彄	nsrr
彃	nwtj
彉	ntlc
彊	nmwm
彋	nwlv
彏	nbue
彔	vnme
彖	vnmo
彘	vmpop
彧	ikrm
彯	mfhhh
彳	ho
彴	hopi
彸	hoci
徂	hobm
彾	hooii
徉	hotq
徠	hodoo
徛	hokmr
徜	hofbr
徦	horse
徥	hoamo
徯	hobvk
徭	hobou
徲	hoseq
徼	hohsk
徾	hourk
徿	hoybp
忀	hoyrv
忁	hoaue
忉	psh
忔	pon
忕	pk
忒	ipp
忑	myp
忐	ymp
忭	pyy
忨	pmmu
忮	pje
忳	ppu
忸	png
忡	pl
忤	poj
忣	pnhe
忺	pno
忯	phvp
忪	pci
忷	puk
忻	phml
忞	ykp
忥	onp
怭	pph
怦	pmfj
怙	pjr
怲	pmob
怋	prvp
怴	piv
怩	psp
怫	plln
怊	pshr
怗	pyr
怳	prhu
怛	pam
怚	pbm
怞	plw
怬	pwc
怢	phqo
怍	pos
怐	ppr
怮	pvis
怓	pve
怷	icp
怹	odp
恔	pyck
恲	ptt
恞	pkn
恅	pjkp
恓	pmcw
恇	psmg
恉	ppa
恛	pwr
恌	plmo
恀	pnin
恂	ppa
恟	ppuk
恝	qhp
恚	ggp
恧	mbp
恁	ogp
悢	piav
悈	pit
悀	pnib
悒	prau
悁	prb
悝	pwg
悃	pwd
悕	pkkb
悛	pice
悗	pnau
悇	pomd
悊	qlp
悐	kfp
悆	omdp
惇	pyrd
悾	pjcm
悰	pjmf
悺	pjrr
惓	pfqu
惔	pff
惏	pdd
惤	pnyi
惙	peee
惝	pfbr
惈	pwd
悱	plmy
惛	phpa
悷	phsk
惉	erp
悹	jrrp
惌	jnup
惢	ppp
惎	tcp
惄	yep
愔	pyta
惲	pbjj
愊	pmrw
愖	ptmv
愅	ptlj
惵	pptd
愓	pamh
愒	papv
惸	ppad
惼	phsb
惾	puce
惷	qap
愍	rkp
愆	hnp
慉	pyvw
慊	ptxc
愫	pqmf
慅	peii
愶	pksb
愲	pbbb
愷	pumt
愮	pbou
慆	pbhx
愯	poge
愬	tbp
愨	gep
慁	wop
慞	pytj
慵	pilb
慱	pjii
慳	pseg
慒	ptwa
慓	pmwf
慲	ptlb
慬	ptlm
憀	psmh
慴	psma
慔	ptak
慺	pllv
慛	puog
慥	pyhr
憋	fkp
憃	qxp
慹	gip
憱	pyfu
憰	pnhb
憢	pggu
憉	pgth
憛	pmwj
憓	pjip
憯	pmua
憭	pkcf
憟	pmwd
憒	plmc
憪	panb
憡	phdb
憍	phkb
憮	potf
憝	ykp
憨	mkp
憖	dkp
懅	pypo
憴	prxu
懆	prrd
懁	pwlv
懌	pwlj
憺	pncr
憿	phsk
憸	pomo
懃	tsp
懋	ddp
憵	sjp
憼	tkp
懧	pjpn
懠	pyx
懥	pjbo
懤	pgni
懨	pmak
懞	ptbo
懘	ebp
懟	tip
懭	pitc
懮	pmbe
懱	ptwi
懪	pate
懰	phcn
懫	phlc
懻	plpc
懽	ptrg
戁	tgp
戃	pfbf
戄	pbue
戇	ycp
戉	iv
戔	ii
戠	yai
酨	jimcw
戣	nki
戥	ami
戩	mai
戧	ori
戭	jci
戺	hsru
戽	hsyj
扂	hsyr
扃	hsbr
扆	hsyhv
扊	hsff
扑	qy
扐	qks
扜	qmd
扞	qmj
扤	qmu
扡	qpd
扦	qhj
扢	qon
抃	qyy
抆	qyk
抌	qlbu
抎	qmmi
抏	qmmu
抔	qmf
抇	qa
扱	qnhe
扻	qno
扺	qhvp
抭	qjhu
抴	qpt
拑	qtm
抾	qgi
抪	qklb
抶	qhqo
拊	qodi
抮	qohh
拏	veq
挍	qyck
挂	qgg
挋	qsll
拵	qkld
挎	qkms
挃	qmig
拫	qav
拹	qkss
挏	qbmr
挌	qher
拸	qnin
拶	qvvn
挀	qhhv
拲	tcq
挐	vrq
捖	qjmu
挬	qjbd
捄	qije
捅	qnib
挶	qssr
捃	qskr
揤	qail
捍	qamj
捌	qrsn
挹	qrau
捋	qbdi
捊	qbnd
挼	qbv
挩	qcru
捁	qhgr
挴	qowy
捘	qice
捔	qnbg
挲	ehq
捥	qjnu
掊	qytr
掂	qiyr
捽	qyoj
掽	qttc
掞	qff
掭	qhkp
掝	qirm
掗	qmlm
掫	qsje
捺	qkmf
掎	qkmr
捯	qmgn
掇	qeee
掐	qnhx
据	qsjr
掯	qymb
捵	qtbc
掜	qhxu
捭	qhwj
掮	qhsb
捼	qhdv
掤	qbb
挻	qnkm
掰	qchq
掔	seq
掱	qqq
揎	qjmm
揥	qybb
揨	qyrn
揯	qpmm
揃	qtbn
撝	qbhf
揳	qqhk
揊	qmrw
揠	qsav
揶	qsjl
揕	qtmv
揲	qptd
揵	qnkq
摡	qaiu
揟	qnob
揹	qlpb
掾	qvno
揝	qhoa
揜	qort
揄	qomn
揘	qhag
揅	mtq
揱	fnq
揫	hfq
搐	qyvw
搒	qybs
搉	qobg
搠	qtub
搤	qtct
搳	qjqr
搆	qttb
摃	qmbc
搟	qjjj
搕	qgit
搘	qjpa
搹	qmrb
搷	qjbc
搢	qmia
搣	qihf
搌	qstv
搦	qnmm
搰	qbbb
搨	qasm
摁	qwkp
搵	qwot
搯	qbhx
搊	qpuu
搚	qksb
摀	qhrf
搥	qyhr
搧	qhsm
搋	qhyu
搴	jtcq
搫	heq
摍	qjoa
摛	qyub
摭	qitf
摝	qixp
摴	qmbs
摶	qjii
摲	qjjl
摳	qsrr
摽	qmwf
摵	qihf
摦	qkso
撦	qkja
摎	qsmh
撂	qwhr
摞	qwvf
摜	qwjc
摋	qkce
摻	qiih
摓	qyhj
摠	qhwp
摐	qhoo
摿	qoya
摮	gkq
摰	giq
撙	qtwi
撢	qmwj
撖	qmjk
撠	qjji
撅	qmto
撗	qtlc
撜	qnot
撏	qsmi
撋	qang
撊	qanb
撌	qlmc
撣	qrrj
撳	qcno
撟	qhkb
擗	qsrj
擖	qtav
擐	qwlv
擏	qtrk
擉	qwli
撾	qybb
撽	qhsk
擯	qjmc
擩	qmbb
擣	qgni
擫	qmak
擢	qsmg
擭	qtoe
擤	qhul
擨	qhuo
擿	qyyb
擷	qgrc
攄	qypp
擽	qvid
擸	qvvv
攇	qjqp
攐	qjtv
攍	qynv
攉	qmbg
攌	qwwv
攗	qipd
攖	qbcv
攕	qoim
攓	qjto
攛	qjcv
攡	qybg
攠	qicy
攦	qmmp
攢	qhuc
攩	qfbf
攭	qvoi
攮	qjbv
攲	krje
攳	jesmi
攷	msok
攸	olok
攽	chok
敁	yrye
敉	fdok
敊	yfye
敆	orye
敕	dlok
敔	mrok
敓	cuok
敧	krye
敪	eeeek
敤	wdye
敜	opok
敯	raye
敳	utok
敶	nldwk
敺	srye
敹	ydok
敻	nbbuk
敿	hbok
斁	wjok
斀	wiye
斄	jkmdo
斌	ykmpm
斒	ykhsb
斔	yihxo
斕	ykanw
斖	ykhbm
斛	nbyj
斝	rrbyj
斞	hoyj
斠	tbyj
斨	vmhml
斪	prhml
斮	tahml
斲	rmhml
斶	hlwli
斻	ysohn
斿	ysond
旆	ysojb
旃	ysoby
旄	ysohu
旂	ysohl
旍	ysooi
旐	ysolo
旒	ysoyu
旓	ysofb
旚	ysomf
旛	ysohw
旞	ysyoo
旝	ysooa
旟	ysohc
旯	akn
旮	kna
旰	amj
旴	amd
旳	apm
昉	ayhs
旼	ayk
昄	ahe
昒	aphh
昕	ahml
昈	ahs
旻	ayk
昊	amk
昃	amo
昇	aht
昶	iea
昡	ayvi
昲	alln
昵	asp
昜	amsh
昦	akll
昢	auu
昳	ahqo
昫	apr
昱	ayt
昺	amob
昝	hoa
昴	ahhl
晅	amam
晊	amig
晟	aihs
晇	akms
晁	almo
晥	ajmu
晡	aijb
晛	abuu
晙	aice
晞	akkb
晜	acnh
晢	qla
晼	ajnu
晾	ayrf
晬	ayoj
晻	aklu
暀	ahog
晷	ahor
暄	ajmm
暆	aysd
暌	anok
暕	adwf
暐	admq
暘	aamh
暍	aapv
暋	rka
暝	abac
暡	acim
暠	ayrb
暵	atlo
暱	astr
暰	ahoo
暩	abof
曈	aytg
暾	aydk
曀	agbt
曊	alnc
曄	atmj
曋	amwj
曇	ambi
曏	avhl
曒	ahsk
曜	asmg
曚	atbo
曛	ahgf
曨	aybp
曣	atlf
曩	ayrv
曭	afbf
曮	arrk
曶	pha
朁	mua
朅	giapv
朄	lldwf
朏	buu
朐	bpr
朒	bobo
朓	blmo
朘	bice
朢	sbhg
朣	bytg
朾	dmn
朹	dkn
朸	dks
朻	dvl
机	dhn
朿	db
朼	dp
杆	dmj
杅	dmd
杇	dmms
杠	dm
杙	dip
杕	dk
杌	dmu
杈	dei
杝	dpd
杓	dpm
杗	yvd
枓	dyj
枅	dmt
杬	dmmu
枎	dqo
枒	dmvh
杶	dpu
杼	dnin
杻	dng
杪	dfh
枘	dob
枆	dhqu
构	dpi
杴	dno
枍	dcms
枌	dcsh
杲	ad
柁	djp
柲	dph
柈	dfq
枰	dmfj
枺	ddj
柜	dss
枻	dpt
柸	dmfm
柘	dmr
柀	ddhe
枷	dksr
柅	dsp
柫	dlln
柤	dbm
柟	dgb
枵	drms
柙	dwl
柍	dlbk
枳	drc
柷	drhu
柶	dwc
柮	duu
柣	dhqo
柂	dopd
枹	dpru
柎	dodi
柢	dhpm
柝	dhmy
柧	dhvo
柒	epd
柰	dmmf
枲	ird
栟	dtt
栚	dtk
桉	djv
栲	djks
栳	djkp
栻	dipm
桋	dkn
桏	dmnl
栖	dmcw
栱	dtc
栜	ddb
栵	dmnn
栫	dkld
栭	dmbl
栯	dkb
桎	dmig
桄	dfmu
栴	doby
栝	dhjr
栘	dnin
栒	dpa
桁	dhon
栔	qhd
梡	djmu
桹	diav
梂	dije
梇	dmgt
梐	dppg
梜	dkoo
桭	dmmv
桮	dmfr
梮	dssr
梫	dsme
楖	dail
桯	drhg
梣	duon
梬	dlws
梩	dwg
桵	dbv
桴	dbnd
梲	dcru
梏	dhgr
桷	dnbg
梒	doir
桼	doe
椌	djcm
棓	dytr
椄	dytv
棜	dysy
椪	dttc
棬	dfqu
棪	dff
棱	dgce
楮	djka
椏	dmlm
棖	dsmv
棷	dsje
棫	dirm
棤	dta
棶	ddoo
椓	dmso
椐	dsjr
棳	deee
棡	dbtu
椇	dbmc
棌	dbd
椈	dpfd
楰	dhxo
梴	dnkm
椑	dhwj
棯	doip
棆	domb
椔	dvvw
棸	sed
棐	lyd
棽	ddoin
棼	ddcsh
棻	tcsd
棨	hkd
楦	djmm
楟	dyrn
椸	dysd
楎	dbjj
楢	dtcw
楱	dqkk
椿	dqka
楅	dmrw
楝	ddwf
楪	dptd
椹	dtmv
楂	ddam
楗	dnkq
楣	dahu
楙	dnhd
楺	dnhd
楈	dnob
楛	dtjr
楉	dtkr
椵	drse
楬	dapv
椳	dwmv
椽	dvno
楥	dbme
棰	dhjm
楸	dhdf
椴	dhje
楩	domk
楀	dhlb
楯	dhju
楄	dhsb
楶	iord
㮣	aud
楘	nkd
榱	dywv
榶	dilr
槉	dkok
榠	dbac
槎	dtqm
榖	gdhne
榰	djpa
榬	dgrv
榼	dgit
榑	dibi
榙	dtor
榎	dmue
榧	dsly
榍	dsfb
榩	dypk
榾	dbbb
榯	dagi
榿	dumt
槄	dbhx
榽	dbvk
榤	dnqd
槔	dhaj
榦	jjod
榹	dhyu
槊	tbd
槃	hed
樀	dycb
樆	dyub
樗	dmbs
槥	dqjm
槸	dggi
樕	ddlo
槱	dmwf
槤	dyjj
樠	dtlb
槿	dtlm
槬	dkso
槭	dihf
槢	dsma
樛	dsmh
樝	dypm
槾	dawe
樧	dkce
槲	dnbj
槮	diih
樔	dvvd
槷	gid
槧	jld
橀	dyit
樴	dyia
橦	dytg
橉	dfdq
橧	dcwa
樲	dipc
橈	dggu
橨	djtc
樾	dgov
橝	dmwj
橭	djrj
橶	djji
橛	dmto
橑	dkcf
樨	dseq
橚	dlx
樻	dlmc
樿	drrj
橁	dhpa
橪	dbkf
橤	pppd
橐	jbmrd
檍	dytp
檖	dyto
檁	dywd
檥	dtgi
檉	dsrg
檟	dmwc
檣	dgow
橾	drrd
檗	sjd
檛	dybb
檡	dwlj
檞	dnbq
檐	dncr
檇	dogs
檓	dhge
檎	doyb
檕	jed
檃	nmd
檠	tkd
櫅	dyx
檹	dysr
檽	dmbb
檮	dgni
檯	dgrg
櫡	dhja
櫆	dhij
櫧	dyra
櫠	dine
櫌	dmbe
櫑	dwww
櫙	dtsr
櫋	dhus
櫟	dvid
櫜	jbhod
櫐	wwwd
櫫	mad
櫳	dybp
櫬	dydu
櫰	dywv
櫪	dmhm
櫨	dypt
櫹	dtlx
櫱	ujd
櫺	dmbr
欂	dtei
櫸	dhcq
櫼	doim
欃	dnri
欋	dbug
欈	duob
欐	dmmp
欑	dhuc
欒	vfd
欘	dsei
欥	ano
欨	prno
欴	iino
欬	yono
欯	grno
欭	wkno
欱	orno
欶	dlno
欳	ybno
欷	kbno
欸	ikno
欹	krno
欻	ffno
欿	nxno
歆	yano
歅	mgno
歃	mxno
歂	ubno
歈	onno
歊	ybno
歍	hfno
歋	huno
歎	tono
歕	jcno
歔	ymno
歜	wino
歛	oono
歠	ewno
歭	ymgdi
殀	mnhk
歾	mnphh
殂	mnbm
殄	mnohh
肂	mnlq
殈	mnhbt
殑	mnjru
殏	mnije
殍	mnbnd
殔	mnle
殗	mnklu
殙	mnhpa
殛	mnmem
殞	mnrbc
殟	mnwot
殠	mnhuk
殥	mnjmc
殣	mntlm
殢	mnkpb
殦	mnhaf
殧	mnyfu
殪	mngbt
殫	mnrrj
殭	mnmwm
殰	mngwc
殳	hne
殶	yghne
殽	kbhne
毃	ybhne
毄	jrhne
毈	hhsle
毇	hdhne
毉	semoo
毊	gehkb
毌	wj
毐	gwj
毖	ppph
毘	wpp
毚	nrppi
毞	pphqu
毦	sjhqu
毤	cuhqu
毨	huhgu
毣	smhqu
毬	huije
毰	huytr
毲	eeeeu
毳	huhuu
毻	kbhqu
毼	avhqu
毹	onhqu
毾	amhqu
氁	hutak
氀	lvhqu
毿	ihhqu
氂	jkmhu
氄	nbhqu
氅	fkhqu
氈	ymhqu
氍	bghqu
气	omn
氕	onl
氘	onll
氙	onu
氚	onlll
氠	onlwl
氪	onjru
氰	onqmb
氬	onmlm
氶	ne
汃	ec
氿	ekn
汆	oe
汒	eyv
污	emms
汜	eru
汏	ek
汊	eei
汛	enj
汍	ekni
汔	eon
汎	ehni
汋	epi
汴	eyy
沆	eyhn
汸	eyhs
汶	eyk
汧	emt
汫	ett
沄	emmi
沍	emvm
沋	eiku
沏	epsh
沔	emls
沘	epp
汱	eik
汯	eki
汩	ea
沚	eylm
汭	eob
沇	eihu
沕	ephh
沜	elll
汦	ehvp
沂	ehml
汳	ehe
沓	ea
泬	ejc
泫	eyvi
泮	efq
泙	emfj
沶	emmf
沬	ejd
泔	etm
沭	eijc
泧	eiv
沷	eikk
泯	ervp
泐	enls
泂	ebr
沺	ew
泃	epr
泆	ehqo
泭	eodi
泜	ehpm
泲	elxh
泒	ehvo
泖	ehhl
泝	ehmy
泠	eoii
沴	eohh
泵	mre
洨	eyck
洴	ett
洭	esmg
洟	ekn
洹	emam
洼	egg
洿	ekms
洒	emcw
洧	ekb
洊	ekld
泚	eymp
洸	efmu
洳	evr
洩	elwp
洄	ewr
洮	elmo
洙	ehjd
洺	enir
洵	epa
洚	eheq
洎	ehbu
洫	ehbt
洑	eoik
洀	ehby
浺	epl
浣	ejmu
浤	ejki
浶	ejhq
洍	esll
涌	enib
浡	ejbd
涒	eskr
浘	eshu
浢	emrt
浭	emlk
浯	emmr
涑	edl
涍	ejkd
涊	esip
淯	eyib
浹	ekoo
涅	eag
浿	ebuc
涆	eamj
浥	erau
浞	eryo
浧	erhg
涔	euon
浠	ekkb
涗	ecru
浰	ehdn
浼	enau
浟	eolk
涂	eomd
涘	eiok
淀	ejmo
涫	ejrr
涴	ejnu
涳	ejcm
涪	eytr
淬	eyoj
湴	ettc
涬	egtj
淩	egce
淢	eirm
涷	edw
淶	edoo
淔	ejbm
涿	emso
渀	ekjt
淈	esuu
淠	ewml
淟	etbc
淖	eyaj
涾	eea
淥	evne
淜	ebb
淝	ebau
淛	ehbn
淴	ephp
淊	enhx
涽	ehpa
淭	ehsd
淰	eoip
淦	ec
淼	eee
湆	eyta
湇	eytb
渟	eyrn
湉	ephr
溈	eikf
渼	etgk
渽	ejir
湅	edwf
湢	emrw
渫	eptd
渿	edmf
湁	eqor
湝	eppa
湳	ejbj
湎	emwl
渜	embk
渳	ensj
湣	erpa
湄	eahu
湋	edmq
湀	enok
湑	enob
渻	efhu
渃	etkr
渮	etmr
湞	eybc
湨	ebuk
湜	eamo
湡	ewlb
渱	elim
渨	ewmv
湠	eumf
湲	ebme
湱	eqjr
湩	ehjg
湫	ehdf
渹	epyr
渢	ehni
湟	ehag
渰	eort
湓	ecst
溛	ejco
滖	eywv
滈	eyrb
溏	eilr
滀	eyvw
溟	ebac
溓	etxc
溔	etgf
溠	etqm
溱	eqkd
溹	ejbf
滆	emrb
滒	emrr
溧	emwd
溽	emvi
滁	enld
溞	eeii
滉	eafu
溷	ewmo
溰	eumt
滍	eumi
溦	euuk
滏	eckc
溲	ehxe
溴	ehuk
溾	ehui
滃	ecim
滜	ehaj
滎	ffbe
滕	bfqe
滵	ejpu
滱	ejme
漃	ejye
漥	ejcg
滸	eyrj
漷	eydl
滻	eykm
漮	eile
漉	eixp
潎	efbk
漙	ejii
漚	esrr
漧	ejjn
漘	emvb
漻	esmh
漒	enii
滭	ewtj
漊	ellv
漶	ellp
潳	esja
滹	eypd
滮	eyuh
漭	etit
滷	eywi
潀	ewlo
漰	eubb
漼	euog
漵	eodk
滫	eolb
漇	ehoo
漎	ehoo
潃	ehob
漅	evvd
漦	jkme
潁	pembc
潾	efdq
澇	effs
濆	ejtc
澒	emmc
澍	egti
澉	emjk
澌	etcl
潢	etlc
潏	enhb
澅	elgm
潯	esmi
潚	elx
潠	eruc
澖	eand
潶	ewgf
潬	errj
澂	eugk
潕	eotf
潲	ehdb
潒	enao
潐	eogf
潗	eogd
潟	ehxf
澔	ehar
澓	ehoe
潝	eorm
澶	eywm
澭	eyvg
濋	eddo
澣	ejjj
濇	egow
澦	ennc
澼	esrj
濎	ebul
濈	erji
澠	erxu
潞	ermr
濄	eybb
澽	eypo
澞	eypk
濊	eymh
澴	ewlv
澨	ehmo
瀄	ehal
澥	enbq
澮	eoma
濌	hgea
澩	hbe
濴	effe
濔	emfb
濣	ejjj
濜	elmt
濭	etgt
濩	etoe
濕	eavf
濧	etgi
濦	ebmp
濞	ehul
濮	eoto
濰	evfg
瀇	eitc
瀌	eipf
瀍	eiwg
瀁	etov
瀅	effi
瀔	egde
瀎	etwi
濿	emtb
瀀	embe
濻	enlc
瀦	emoa
濼	evid
瀙	eydu
瀧	eybp
瀠	efff
瀖	embg
瀫	egfe
瀡	enlb
瀢	eylc
瀘	eypt
瀣	eyem
瀩	ehuc
瀼	eyrv
瀵	efdc
瀯	effr
瀷	esmc
瀴	ebcv
瀱	ewln
灂	ebwi
瀸	eoim
瀿	eokf
瀺	enri
瀲	eook
瀹	eomb
灃	eujt
灄	esjj
灊	emub
灈	ebug
灉	evug
灕	eybg
灖	eicy
灗	elim
灛	eanj
灞	embb
灟	esei
灡	etaw
灝	eafc
灨	eyjc
灩	eutt
灪	eddh
炔	fdk
炘	fhml
炅	af
炷	fyg
炤	fshr
炟	fam
炾	frhu
炱	irf
炰	puf
烜	fmam
烓	fgg
烑	flmo
烝	nemf
烋	odf
缹	ouf
烺	fiav
焍	fcnh
烷	fjmu
焗	fssr
烴	fmvm
焌	fice
烯	fkkb
烰	fbnd
焄	srf
焠	fyoj
焞	fyrd
焯	fyaj
焜	fapp
烻	fnkm
焮	fhlo
焱	fff
焣	sef
煇	fbjj
煔	ffyr
煒	fdmq
煆	frse
煣	fnhd
煠	fptd
煁	ftmv
煝	fahu
煨	fwmv
煖	fbme
煢	ffbnj
煲	odf
熇	fyrb
熐	fbac
熉	frbc
熀	fafu
熅	fwot
熂	fond
熒	ffbf
熏	hgf
熲	pfmbc
熯	ftlo
熛	fmwf
熰	fsrr
熠	fsma
熚	fwtj
燅	ggff
燂	fmwj
熿	ftlc
熸	fmua
燖	fsmi
燀	frrj
燁	ftmj
燋	fogf
燔	fhdw
燊	fffd
燡	fwlj
燠	fhbk
燼	flmt
爁	fsit
燿	fsmg
燾	gnmf
燹	mof
爌	fitc
爊	fipf
爇	tgif
爂	hbf
爓	fanx
爝	fbwi
爚	fomb
爞	flii
爟	ftrg
爢	iyf
爣	ffbf
牁	vmmnr
牂	vmtq
牄	vmoir
牉	llfq
牋	llii
牏	llomn
牓	llybs
牚	fbrmh
牣	hqshi
牬	hqlxh
牰	hqlw
牸	hqjnd
牷	hqomg
牾	hqmmr
牻	hqiuh
牼	hqmvm
牿	hqhgr
犈	hqfqu
犉	hqyrd
犆	hqjbm
犅	hqbtu
犍	hqnkq
犌	hqrse
犑	hqbuk
犐	hqhdj
犎	gihq
犗	hqjqr
犕	hqthb
犓	hqpuu
犘	idhq
犚	sihq
犝	hqytg
犞	hqhkb
犥	hqipf
犦	hqate
犤	hqwlp
犣	hqvvv
犨	oghq
犩	hihq
犪	hqtce
犮	ikk
犰	khkn
犴	khmj
犵	khon
犿	khyy
犽	khmvh
狃	khng
狆	khl
狁	khihu
狖	khjc
狋	khmmf
狘	khiv
狉	khmfm
狜	khjr
狒	khlln
狔	khsp
狚	kham
狌	khhqm
狑	khoii
狊	buik
狤	khgr
狨	khij
狫	khjkp
狟	khmam
狪	khbmr
狦	khbtt
狣	khlmo
猀	khefh
狺	khymr
狴	khppg
狾	khqhl
狶	khkkb
狳	khomd
狻	khice
猝	khyoj
猗	khkmr
猇	khypu
猑	khapp
猘	khhbn
猊	khhxu
猈	khhwj
狿	khnkm
猏	khhsb
猋	ikikk
猒	abik
猰	khqhk
猢	khjrb
猱	khnhd
猳	khrse
猧	khbbr
猲	khapv
猭	khvno
猦	khhni
猣	khuce
猵	khhsb
猼	khibi
獂	khmhf
猻	khndf
猺	khbou
獀	khhxe
獊	khoir
獃	utik
獍	khytu
獑	khjjl
獌	khawe
獘	fkik
獒	gkik
獞	khytg
獟	khggu
獠	khkcf
獝	khnhb
獛	khtco
獡	khhxf
獩	khymh
獦	khtav
獧	khwlv
獬	khnbq
獥	khhsk
獫	khomo
獪	khoma
獳	khmbb
獮	khmfb
獯	khhgf
獶	khmbe
獽	khyrv
獼	khnmb
獾	khtrg
獿	khmce
玂	khtjl
玁	khrrk
玃	khbue
玅	yifh
玆	yiyvi
玈	yiohv
玊	mgi
玎	mgmn
玕	mgmj
玗	mgmd
玓	mgpi
玔	mglll
玤	mgqj
玡	mgmvh
玭	mgpp
玦	mgdk
玢	mgcsh
玠	mgoll
珌	mgph
珂	mgmnr
珈	mgksr
珅	mglwl
珓	mgyck
珪	mggg
珙	mgtc
珥	mgsj
珖	mgfmu
玼	mgymp
珧	mglmo
珣	mgpa
珞	mgher
珩	mghon
珶	mgcnh
珸	mgmmr
珵	mgrhg
琄	mgrb
琁	mgono
珽	mgnkg
琇	mghds
琀	mgoir
琮	mgjmf
琯	mgjrr
琬	mgjnu
琛	mgbcd
琰	mgff
琫	mgqkq
琖	mgii
琦	mgkmr
琚	mgsjr
琡	mgyfe
琨	mgapp
琭	mgvne
琱	mgbgr
琤	mgbsd
瑄	mgjmm
瑊	mgihr
瑋	mgdmq
瑒	mgamh
瑑	mgvno
瑗	mgbme
瑀	mghlb
瑢	mgjcr
瑳	mgtqm
瑱	mgjbc
瑵	mgeii
瑲	mgoir
璇	mgyso
璉	mgyjj
璊	mgtlb
瑾	mgtlm
璆	mgsmh
璀	mguog
璁	mghwp
瑽	mghoo
璅	mgvvd
瑿	semgi
璘	mgfdq
璚	mgnhb
璟	mgayf
璞	mgtco
璠	mghdw
璗	ehmgi
璲	mgyto
璫	mgfbw
璨	mgyed
璐	mgrmr
璪	mgrrd
璸	mgjmc
瓀	mgmbb
璵	mghxc
璿	mgybu
瓁	mgtoe
瓋	mgyyb
瓅	mgvid
璺	hbmgi
瓖	mgyrv
瓔	mgbcv
瓘	mgtrg
瓚	mghuc
瓛	mgybk
瓝	hopi
瓞	hohqo
瓟	hopru
瓡	gjhvo
瓤	yvhvo
瓥	holii
瓨	mmvn
瓬	ysmvn
瓮	cimn
瓴	oimvn
瓵	irmvn
瓿	yrmvn
瓾	hvmvn
瓽	fbrmn
甀	hmmvn
甂	hbmvn
甃	hfmvn
甈	hdmvn
甋	ybmvn
甍	twln
甐	fqmvn
甑	camvn
甒	ofmvn
甔	nrmvn
甓	sjmvn
甖	bcmvn
甗	ybmvn
甝	yutm
甡	hmhqm
甪	hbq
甮	phbq
甯	jpbq
町	wmn
甹	lwmvs
甿	wyv
畀	wml
甾	vvw
畎	wik
畋	wok
畇	wpmm
畛	wohh
畟	wche
畤	wgdi
畣	orw
畯	wice
畬	omdw
畹	wjnu
畷	weee
畽	whjg
畿	viw
疀	vwjlo
疌	jlyo
疐	jbwno
疔	kmn
疕	kp
疢	kf
疣	kiku
疧	khvp
疰	kyg
痂	kksr
痁	kyr
疻	krc
疸	kam
痄	kos
痀	kpr
痎	kyvo
痒	ktq
痍	kkn
痏	kkb
痋	klmi
痌	kbmr
痑	knin
痧	kefh
痚	kjkd
痡	kijb
痦	kmmr
痝	kiuh
痟	kfb
痤	koog
痗	kowy
痠	kice
痯	kjrr
瘏	kjka
痳	kdd
瘃	kmso
痷	kklu
痾	knlr
痼	kwjr
痹	kwml
痸	khbn
瘐	khxo
痻	khpa
瘖	kyta
瘈	kqhk
瘌	kdln
瘕	krse
瘑	kbbr
瘊	konk
瘥	ktqm
瘞	kkog
瘙	keii
瘝	kwle
瘢	khye
瘜	khup
瘣	khui
瘯	kysk
瘭	kmwf
瘱	kkop
瘽	ktlm
瘳	ksmh
瘺	ksmb
瘼	ktak
瘵	kbof
瘲	khoo
癃	knlm
癈	knoe
癉	krrj
癇	kanb
癜	ksce
癤	khal
癙	khxv
癐	koma
癓	khok
癠	kyx
癟	khub
癪	khdc
癭	kbcv
癰	kvug
癵	kvfb
癹	nohne
皁	haj
皊	haoii
皋	hakj
皏	hatt
皕	mama
皙	dlha
皜	hayrb
皝	hgfmu
皞	hahaj
皛	hahaa
皤	hahdw
皦	hahsk
皫	haipf
皭	habwi
皯	demj
皵	tadhe
皸	bjdhe
皻	ymdhe
皽	ymdhe
皾	gcdhe
盄	nlbt
盅	lbt
盉	hdbt
盓	edbt
盝	vebt
盦	oint
盩	gkbt
盬	srbt
盭	vkbt
盳	buyv
盱	bumd
眈	bulbu
眃	bummi
眄	bumls
眅	buhe
眇	bufh
眊	buhqu
盷	bupim
盻	bucms
眝	bujmn
眛	bujd
眐	bumym
眓	buiv
眒	bulwl
眣	buhqo
眑	buvis
眕	buohh
眙	buir
眚	hmbu
眢	nubu
眹	butk
眯	bufd
眭	bugg
眱	bukn
眲	busj
眴	bupa
眳	bunir
眽	buhhv
眥	ypbu
睆	bujmu
睇	bucnh
睄	bufb
睍	bubuu
睅	buamj
睊	burb
睎	bukkb
睋	buhqi
睌	bunau
睕	bujnu
睟	buyoj
睠	bufqu
睒	buff
睖	bugce
睚	bumgg
睩	buvne
睢	buog
睧	buhpa
睔	buomb
瞁	bubuk
睼	buamo
瞅	buhdf
瞂	huikk
睮	buomn
瞀	nkbu
睯	rkbu
睾	hwgtj
瞋	bujbc
瞍	buhxe
瞏	wlgrv
瞉	guhne
瞚	bujmc
瞝	buyub
瞡	buqou
瞜	bullv
瞛	buhoo
瞢	twlu
瞵	bufdq
瞫	bumwj
瞲	bunhb
瞷	buana
瞶	bulmc
瞴	buotf
矂	burrd
瞼	buomo
矉	bujmc
矊	buvfb
矌	buitc
矎	bunbe
矏	buhus
矍	buoge
矐	bumbg
矔	butrg
矕	vfbu
矘	bufbf
矙	buank
矞	nhbcr
矠	nhta
矧	oknl
矬	okoog
矰	okcwa
矱	oktoe
矲	okwlp
矸	mrmj
矼	mrm
矹	mrmu
矻	mron
矺	mrhp
砆	mrqo
砑	mrmvh
砒	mrpp
砅	mre
砐	mrnhe
砏	mrcsh
砎	mroll
砉	qjmr
砣	mrjp
砬	mryt
砢	mrmnr
砵	mrdm
砠	mrbm
砯	mrie
砟	mros
砲	mrpru
砨	mrhsn
砮	vemr
硎	mrmtn
硈	mrgr
硒	mrmcw
硉	mrlq
硍	mrav
硊	mrnmu
硌	mrher
砦	ypmr
硠	mriav
硤	mrkoo
硥	mriuh
硜	mrmvm
硭	mrtyv
硱	mrwd
硪	mrhqi
确	mrnbg
硰	ehmr
硩	qlmr
碇	mrjmo
碚	mrytr
碔	mrmpm
碏	mrta
碄	mrdd
碕	mrkmr
碅	mrwhd
碓	mrog
碆	eemr
碲	mrybb
碪	mrtmv
碴	mrdam
碭	mramh
碣	mrapv
碨	mrwmv
硾	mrhjm
碫	mrhje
碞	rrrr
磍	mrjqr
碻	mryrb
磏	mrtxc
磌	mrjbc
磑	mrumt
磎	mrbvk
磔	mrnqd
磈	mrhui
磃	mrhyu
磝	mrgsk
磧	mrqmc
磩	mrihf
磥	mrwvf
磪	mruog
磞	mrubb
磣	mriih
磛	jlmr
磳	mrcwa
磽	mrggu
磻	mrhdw
磼	mrogd
磿	mhdr
礌	mrmbw
礓	mrmwm
礔	mrsrj
礉	mrhsk
礐	hbmr
礝	mrmbb
礛	mrsit
礴	mrtei
礜	hcmr
礥	mrsec
礣	mrtwi
礧	mrwww
礨	wwwr
礭	mrmbg
礱	ypmr
礵	mrmbu
礽	ifnhs
祂	ifpd
礿	ifpi
祊	ifyhs
祌	ifl
祋	ifhne
祅	ifhk
祔	ifodi
祛	ifgi
祏	ifmr
祜	ifjr
祓	ifikk
祒	ifshr
祑	ifhqo
祤	ifsmm
祧	iflmo
祩	ifhjd
祪	ifnmu
祣	ifohv
祫	ifomr
祡	ypmmf
祴	ifit
祳	ifmmv
祲	ifsme
祼	ifwd
禂	ifbgr
禘	ifybb
禊	ifqhk
禋	ifmwg
禖	iftmd
禕	ifdmq
禔	ifamo
禓	ifamh
禗	ifwp
禚	iftgf
禡	ifsqf
禠	ifhyu
禜	ffbmf
禫	ifmwj
禨	ifvii
禭	ifyto
禬	ifoma
禰	ifmfb
禴	ifomb
禳	ifyrv
禷	iffkc
禸	ib
禺	wlbi
离	yukb
歶	ypwlb
秈	hdu
秅	hdhp
秕	hdpp
种	hdl
秏	hdhqu
秖	hdhvp
秎	hdcsh
秘	hdph
秫	hdijc
秬	hdss
秠	hdmfm
秮	hdir
秭	hdlxh
秪	hdhpm
秺	hdjhp
秸	hdgr
秶	iohd
稂	hdiav
稊	hdcnh
稃	hdbnd
稌	hdomd
稑	hdgcg
稘	hdtmc
稙	hdjbm
稞	hdwd
稒	hdwjr
稗	hdhwj
稫	hdmrw
穊	hdaiu
稰	hdnob
稯	hduce
稹	hdjbc
穋	hdsmh
穄	hdbof
穈	idhd
穜	hdytg
穛	hdogf
穖	hdvii
穟	hdyto
穠	hdtwv
穧	hdyx
穨	hulmc
穮	hdipf
穬	hditc
穭	hdnwa
穰	hdyrv
穱	hdbwi
穸	jcni
窀	jcpu
穾	jchk
窆	jchio
窉	jcmob
窅	jcbu
窋	jcuu
窌	jchhl
窊	jchvo
窏	jcemd
窔	jcyck
窐	jcgg
窙	jcjkd
窣	jcyoj
窢	jcirm
窞	jcnhx
窨	jcyta
窫	jcqhk
窬	jcomn
窲	jcfdj
窴	jcjbc
窳	jchoo
窶	jcllv
窸	jchdp
窵	jchaf
窱	jcold
窾	jcgfo
竀	jcmmu
窿	jcnlm
竁	jchuu
竑	ytki
竘	ytpr
竦	ytdl
竫	ytbsd
竷	yjhee
笐	hyhn
笄	hmt
笓	hpp
笅	hkk
笏	hphh
笈	hnhe
笊	hhlo
笵	hesu
笻	hmsl
笴	hmnr
笥	hsmr
笰	hlln
笢	hrvp
笤	hshr
笳	hksr
笘	hyr
笪	ham
笝	hwe
笮	hos
笱	hpr
笫	hlxh
笭	hoii
笯	hve
笲	hit
筊	hyck
筇	hmnl
筑	hmhn
筄	hlmo
筈	hhjr
筌	homg
筦	hjmu
筤	hiav
筭	hmgt
筴	hkoo
筮	hmoo
筩	hnib
筲	hfb
筥	hrhr
筧	hbuu
筳	hnkg
筱	holk
筰	hoos
筡	homd
箈	heir
箜	hjcm
箊	hysy
箑	hjlo
箐	hqmb
箸	hjka
箖	hdd
箍	hqsb
箌	hmgn
箛	hndo
箎	hypu
箅	hwml
箇	hwjr
箘	hwhd
劄	hrln
箙	hbse
箄	hhwj
箷	hysd
篋	hsko
箾	hfbn
箬	htkr
篎	hbuh
箠	hhjm
箯	homk
篌	honk
箹	hvfi
篞	heam
篞	heag
篣	hybs
篧	hobg
篝	httb
篕	hgit
篥	hmwd
篚	hsly
篨	hnld
篹	hbuu
篔	hrbc
篦	hhwp
篪	hhyu
簅	hykm
簏	hixp
篲	hqjm
簀	hqmc
篿	hjii
篻	hmwf
簌	hdlo
簎	hqta
篴	hymo
簋	havt
篳	hwtj
簂	hwim
簉	hyhr
簃	hhdn
篠	hold
簁	hhoo
篸	hiih
篽	hhol
簜	heah
簩	hffs
簙	hjii
簠	hibt
簟	hmwj
簭	hgcr
簝	hkcf
簦	hnot
簨	hruc
簢	hank
簥	hhkb
簳	hjjj
簼	hqtb
籀	hqhw
簹	hfbw
簬	hrmr
簻	hybb
籉	hgrg
籈	hmgn
籊	hsmg
籔	hlvk
籗	hmbg
籜	hqwj
籙	hcve
籛	hcii
籧	hyyo
籣	hanw
籥	homb
籦	hchg
籩	hyhs
籯	hync
籽	fdnd
籺	fdon
籸	fdnj
籹	fdv
粄	fdhe
粑	fdau
粊	ppfd
粔	fdss
粘	fdyr
粕	fdha
粢	mofd
粲	yefd
粻	fdsmv
粿	fdwd
粼	fqvv
粺	fdhwj
糅	fdnhd
糈	fdnob
糌	fdhoa
糒	fdthb
糔	fdeii
糗	fdhuk
糝	fdiih
糬	fdwla
糪	sjfd
糰	fdwji
糲	fdmtb
糴	odsmg
糱	ujfd
糶	udsmg
糷	fdtaw
紆	vfmd
紃	vflll
紈	vfkni
紞	vflbu
紝	vfhg
紑	vfmf
紎	vfik
紘	vfki
紖	vfnl
紓	vfnin
紟	vfoin
紒	vfoll
紵	vfjmn
紽	vfjp
紸	vfyg
紶	vfgi
紲	vfpt
紺	vftm
紱	vfikk
絅	vfbr
紬	vflw
紩	vfhqo
絁	vfopd
絇	vfpr
紾	vfohh
紿	vfir
絘	vfimo
絯	vfyvo
絣	vftt
絓	vfgg
絰	vfmig
絖	vffmu
絧	vfbmr
絪	vfwk
絏	vflwp
絳	vfheq
絭	fqvif
絜	qhvif
絫	iiif
綈	vfcnh
綆	vfmlk
綀	vfdl
綍	vfjbd
絿	vfije
綅	vfsme
絺	vfkkb
綎	vfnkg
絻	vfnau
綃	vffb
絼	vfbsh
綌	vfcor
絛	olof
綔	kshvf
綧	vfyrd
綷	vfyoj
緂	vfff
綣	vffqu
綪	vfqmb
緁	vfjlo
緀	vfjlv
緅	vfsje
綝	vfdd
緎	vfirm
緄	vfapp
緆	vfaph
緋	vflmy
綬	vfbbe
緌	vfhdv
綯	vfpou
綹	vfhor
綖	vfnkm
綼	vfhwj
綟	vfhsk
綦	tcvif
綮	hkvif
緷	vfbjj
緛	vfmbk
緪	vfpmm
緧	vftcw
緗	vfdbu
緙	vftlj
緡	vfrpa
縃	vfnob
緺	vfbbr
緦	vfwp
緲	vfbuh
緹	vfamo
緶	vfomk
緱	vfonk
緰	vfomn
縒	vftqm
縡	vfjyj
縞	vfyrb
縗	vfywv
縌	vfytu
縟	vfmvi
縠	gfhne
縝	vfjbc
縓	vfmhf
縉	vfmia
縎	vfbbb
縜	vfrbc
縕	vfwot
縚	vfbhx
縢	bfqf
縐	vfpuu
縋	vfyhr
縏	hevif
縭	vfyub
縼	vfyso
繂	vfyij
縴	vfyvq
縳	vfjii
縹	vfmwf
顈	pfmbc
繈	vfnii
縸	vftak
縵	vfawe
縪	vfwtj
繉	vfbuo
繀	vfuog
繇	buhvf
縩	vfbof
緵	vfuce
縰	vfhoo
縿	vfiih
縻	idvif
縶	givif
繄	sevif
繒	vfcwa
繜	vftwi
繐	vfjip
繖	vftbk
繣	vflgm
繘	vfnhb
繢	vflmc
繟	vfrrj
繙	vfhdw
繑	vfhkb
繠	pppf
繶	vfytp
繵	vfywm
繸	vfyto
繰	vfrrd
繷	vftwv
繯	vfwlv
繺	vfnkf
繳	vfhsk
繲	vfnbq
繴	sjvif
繻	vfmbb
繾	vfylr
纁	vfhgf
纀	vfoto
纊	vfitc
纇	ffmbc
纈	vfgrc
纋	vfmbe
纆	vfwgg
纍	wwwf
纑	vfypt
纕	vfyrv
纔	vfnri
纗	vfuob
纚	vfmmp
纘	vfhuc
纛	qmwyf
缾	ouyjj
缿	ouhmr
罃	ffbou
罅	ouypd
罋	yvgu
罊	jeoju
罌	bcoju
罍	wwwu
罏	ouypt
网	bkk
罘	wlmf
罜	wlyg
罡	wlmym
罞	wlnih
罠	wlrvp
罝	wlbm
罛	wlhvo
罣	wlgg
罥	wlrb
罦	wlbnd
罭	wlirm
罫	wlggy
罧	wldd
罨	wlklu
罬	wleee
罳	wlwp
罶	wlhhw
罻	wlsfi
罼	wlwtj
罺	wlvvd
罿	wlytg
罾	wlcwa
罽	wlmfn
羃	wltab
羆	wlipf
羇	wltjr
羉	wlvff
羑	tgno
羍	ktq
羖	tqhne
羒	tqcsh
羜	tqjmn
羝	tqhpm
羕	tgine
羛	tglln
羢	tqij
羠	tqkn
羡	tgimo
羦	tqjmu
羥	tqmvm
羧	tqice
羬	tqihr
羰	tqumf
羭	tqomn
羱	tqmhf
羵	tqjtc
羳	tqhdw
羷	tqomo
羺	tqmbb
羼	stqq
羾	smm
翃	kismm
翂	smcsh
翊	ytsmm
翋	smyt
翍	smdhe
翐	smhqo
翑	smpr
翇	smikk
翏	smohh
翛	olom
翜	smkoo
翢	brsmm
翣	smytv
翥	jasmm
翭	smonk
翫	sammu
翪	smuce
翬	smbjj
翦	tbnm
翨	smamo
翮	mbsmm
翯	smyrb
翴	smyjj
翲	mfsmm
翽	yhsmm
翾	wvsmm
翿	gismm
耄	jphqu
耇	jkpr
耋	jpmig
耎	mbk
耑	umbl
耏	mbhhh
耔	qdnd
耖	qdfh
耟	qdss
耞	qdksr
耡	qdbms
耤	qdta
耦	qdwlb
耪	qdybs
耨	qdmvi
耬	qdllv
耰	qdmbe
耴	sju
耵	sjmn
耷	ksj
耾	sjki
耹	sjoin
聇	sjmym
聃	sjgb
聈	sjvis
聑	sjsj
聏	sjmbl
聒	sjhjr
聝	sjirm
聵	sjlmc
聹	sjjpn
肏	oobo
肕	bshi
肙	rb
肐	bon
肒	bkni
肜	bhhh
肮	byhn
肣	boin
肸	bcj
肵	bhml
胘	byvi
胇	blln
胠	bgi
胑	brc
胈	bikk
胂	blwl
胐	buu
胅	bhqo
胣	bopd
胙	bos
胜	bhqm
胊	bpr
胕	bodi
胉	bha
胝	bhpm
胏	blxh
胗	bohh
胺	bjv
胲	byvo
胼	btt
胹	bmbl
胯	bkms
胵	bmig
脁	blmo
胻	bhon
脀	nemb
胾	jiobo
胔	ypobo
脘	bjmu
脰	bmrt
脥	bkoo
脤	bmmv
脙	bije
脛	bmvm
脭	brhg
脟	bbdi
脬	bbnd
脞	boog
脡	bnkg
脕	bnau
脧	bice
腃	bfqu
腊	bta
腌	bklu
腒	bsjr
腏	beee
腄	bhjm
腓	blmy
腇	bhdv
脽	bog
腴	bhxo
腍	boip
腤	byta
腠	bqkk
腷	bmrw
腜	btmd
腩	bjbj
腛	bsmg
腢	bwlb
腲	bwmv
朡	buce
腞	bvno
腶	bhje
腧	bomn
腯	bhju
膉	btct
膆	bqmf
膃	bwot
膇	byhr
膍	bhwp
膌	bfcb
膂	yvb
膋	ffbb
膣	bjcg
膟	byij
膘	bmwf
膞	bjii
膕	bwim
膢	bllv
膱	byia
膦	bfdq
膮	bggu
膹	bjtc
膵	btyj
膫	bkcf
膰	bhdw
膬	bhuu
膴	botf
膲	bogf
臇	bogs
膷	bvhl
膻	bywm
臄	bypo
臌	bgte
臊	brrd
臅	bwli
臑	bmbb
臒	btoe
臐	bhgf
臗	bjti
臕	bipf
臛	bmbg
臙	btlf
臝	ynwd
臞	bbug
臢	bhuc
臠	vfobo
臡	tgobo
臦	slsll
臩	sskll
臮	huooo
臲	hdnmu
臷	jimig
臸	mgmig
臿	hjhx
舁	hxt
舄	hxpf
舋	hbbm
舑	hrgb
舕	hrff
舝	dmvvq
舠	hysh
舡	hym
舯	hyl
舸	hymnr
舳	hylw
舺	hywl
舴	hyos
舲	hyoii
舼	hytc
舽	hyheq
艉	hyshu
艄	hyfb
艀	hybnd
艂	hyhej
艅	hyomd
艋	hyndt
艏	hythu
艓	hyptd
艒	hyabu
艐	hyuce
艎	hyhag
艑	hyhsb
艕	hyybs
艛	hyllv
艟	hyytg
艤	hytgi
艨	hytbo
艫	hyypt
艴	lnnau
艵	ttnau
艸	uu
艼	tmn
芀	tsh
艽	tkn
芐	tmy
芏	tg
芅	tip
芎	tn
芑	tsu
芓	tnd
芊	thj
芃	thni
芄	tkni
芔	uuu
芠	tyk
苀	tyhn
芯	tp
芫	tmmu
芸	tmmi
芚	tpu
芘	tpp
芣	tmf
芰	tje
芾	tjb
芛	tsk
芵	tdk
芧	tnin
芮	tob
芷	tylm
芼	thqu
芞	tomn
芺	thk
芴	tphh
芨	tnhe
芡	tno
芩	toin
苙	tyt
苾	tph
苹	tmfj
苯	tdm
茇	tikk
苨	tsp
茀	tlln
苕	tshr
茺	tyiu
苫	tyr
苖	tlw
苴	tbm
苬	two
苡	tvio
苲	tos
苵	thqo
茌	tog
苻	todi
茆	thhl
苶	tof
茳	tem
茨	tmmo
茭	tyck
荄	tyvo
茙	tij
荑	tkn
茥	tgg
荖	tjkp
茿	tmhn
荁	tmam
茦	tdb
茜	tmcw
茢	tmnn
荂	tkms
荎	tmig
茛	tav
茪	tfmu
茈	tymp
茼	tbmr
荍	tvlk
茖	ther
茤	tnin
茠	tod
茷	toi
茯	toik
茩	thmr
荇	thon
荃	tomg
荅	tomr
茻	uuuu
莐	telu
莣	tyvp
莨	tiav
莍	tije
荺	tgpm
荳	tmrt
莆	tijb
莤	tmcw
荴	tqqo
莏	tqfh
莁	tmoo
莕	tdr
莙	tskr
荵	tsip
莧	tbuu
莔	twcb
莩	tbnd
荽	tbv
莃	tkkb
莌	tcru
莝	toog
莛	tnkg
莪	thqi
莋	toos
荾	tice
莥	tkhg
菏	temr
菹	tebm
萣	tjmo
菀	tjnu
菨	tytv
萒	tycu
菧	tihm
菤	tfqu
菼	tff
菶	tqkq
萐	tjlo
萇	tsmv
菆	tsje
菈	tqyt
菫	tmlm
菣	tsle
莿	tdbn
萁	ttmc
菝	tqik
菥	tdhl
菘	tdci
菿	tmgn
菡	tune
菋	trjd
菎	tapp
菖	taa
菵	tbtv
菉	tvne
萉	tbau
菔	tbse
菟	tnai
萏	tnhx
菞	thdh
萑	tog
萆	thwj
菂	thai
菳	tc
菕	tomb
菺	thsb
菇	tvjr
菑	tvvw
蓱	tett
萿	tehr
葖	tjck
葶	tyrn
葹	tysd
蒍	tikf
葥	ttbn
葑	tggi
葀	tqhr
葧	tjds
萰	tdwf
葍	tmrw
葽	tmwv
葚	ttmv
葙	tdbu
葴	tihr
葳	tihv
葝	tmms
蔇	taiu
葞	tnsj
萷	tfbn
葭	trse
萺	tabu
萴	tbcn
葺	trsj
葃	taos
葸	twp
萲	tbme
葅	toom
萩	thdf
菙	thjm
葋	tbpr
萯	tnbc
葂	tnus
萭	thlb
葟	thag
葆	tord
葰	toie
萹	thsb
葎	thoq
葌	tvvv
葒	tvfm
葯	tvfi
蒗	teiv
蒤	teod
蒡	tybs
蒟	tytr
蓑	tywv
蒺	tkok
蓎	tilr
蓂	tbac
蒬	tbni
蒮	tobg
蒫	ttqm
蒹	ttxc
蒴	ttub
蓁	tqkd
蓍	tjpa
蒪	tibi
蒚	tmrb
蒱	tqib
蓐	tmvi
蒝	tmhf
蒧	tihr
蒻	tnmm
蒢	tnld
蒔	tagi
蓇	tbbb
蓌	tooe
蒛	touk
蒩	thdm
蒯	tbln
蒨	toqb
蓖	thwp
蒘	tvrq
蒶	tvfh
蓊	tcim
蓏	thoo
蒠	thup
蔆	tege
蔤	tjpu
蔻	tjme
蔏	tycb
蔀	tyrl
蔩	tjmc
蔎	tyre
蔉	tycv
蔍	tixp
蔟	tysk
蔊	tfaj
蔧	tqjm
蔜	tgsk
蓻	tgji
蔫	tmyf
蓺	tggi
蔈	tmwf
蔌	tdlo
蓴	tjii
蔪	tjjl
蓲	tsrr
蔕	tkpb
蓷	tqog
蓫	tymo
蓳	ttlm
蓼	tsmh
蔒	tsrf
蓪	tynb
蓩	tnhs
蔖	typm
蓾	tywi
蔨	twfu
蔝	tbud
蔮	twim
蔂	twvf
蓽	twtj
蔞	tllv
蓶	trog
蔱	tkce
蔦	thaf
蓧	told
蓨	tolb
蓰	thoo
蓯	thoo
蓹	thol
蔘	tiih
蔠	tvfy
蔰	thsu
蕖	tesd
蕅	tewb
蕫	tytg
蕍	teon
蕓	tmbi
蕡	tjtc
蕘	tggu
蕀	tdbb
蕆	tihc
蕤	tmom
蕁	tsmi
蕞	tase
蕢	tlmc
蕄	tanp
蕑	tanb
蕇	trrj
蕣	tbbq
蔾	thhd
蕛	thdh
蕱	thdb
蕎	thkb
蕵	tniv
蕮	thxf
蕕	tkhw
蕧	thoe
蕠	tvrf
薌	tvhl
蕦	thhc
蕝	tvfu
薃	teyb
薀	tewt
薏	tytp
薧	tyrp
薕	titc
薠	tfmc
薋	tioc
薣	tgte
蕻	tsic
薤	tmnm
薚	tmnh
薞	tmnv
蕷	tnnc
蕼	tsiq
薉	tymh
薡	tbul
蕺	trji
蕸	tyre
蕗	trmr
薎	twli
薖	tybb
薨	twlp
薆	tbbe
薍	tbbu
薙	tokg
薝	tncr
薊	tnfn
薁	thbk
薢	tnbq
薂	thsk
薈	toma
薅	tvmi
薴	tjpn
藆	tjtq
藀	tfff
薺	tyx
藃	tybo
藂	tseo
薹	tgrg
薳	tygv
薵	tgni
薽	tmgn
藇	thxc
藄	ttcf
薿	tpko
藋	tsmg
藎	tlmt
藈	tbuk
藅	twln
薱	ttgi
薶	tbhg
藒	thdv
蘤	thaf
藫	temj
藱	tkhi
藭	tjcn
藙	tyoe
藡	tyyb
藨	tipf
藷	tyra
藚	tgwc
藗	tydo
藲	tdsr
藬	tnlc
藸	tmoa
藘	typp
藟	twww
藣	twlp
藜	thhe
藑	tnbe
藰	thcn
蘢	tybp
藿	tmbg
蘁	tmgr
藾	tdlc
蘛	ttvb
蘀	tqwj
藶	tmhm
蘄	trjl
蘉	twle
蘅	thon
蘌	thlf
蘘	tyrv
蘪	tipd
蘦	tmbr
蘟	tnlp
蘣	ttcg
蘜	ttjd
蘙	tsem
蘧	tyyo
蘮	twln
蘡	tbcv
蘠	tvmw
蘩	tokf
蘞	took
蘥	tomb
蘴	tujt
蘵	tsja
蘳	ttcg
蘬	thmb
蘺	tybg
虀	tysm
虀	tyxm
蘹	tpyv
蘼	ticy
蘱	tfkc
蘻	tjef
蘾	tgyv
虃	teom
虆	twwf
虇	tntg
虈	trrr
虌	tfku
虋	thbh
虓	knypu
虒	hypu
虙	ypph
虖	yphfd
虡	yptmc
虢	biypu
虣	mmypu
虩	ffypu
虪	yuolf
虰	limn
虯	livl
虭	lish
虮	lihn
虻	liyv
虷	limj
虺	mulmi
虴	lihp
蚢	liyhn
蚨	liqo
蚖	limmu
蚍	lipp
蚑	lije
蚞	lid
蚜	limvh
蚇	liso
蚗	lidk
蚆	liau
蚋	liob
蚚	lihml
蚅	lihsu
蚥	lick
蚙	lioin
蚡	licsh
蚧	lioll
蚕	hklmi
蚕	mklmi
蚿	liyvi
蚷	liss
蛂	liikk
蛁	lishr
蛅	liyr
蚺	ligb
蚰	lilw
蛈	lihqo
蚹	liodi
蚳	lihpm
蛉	lioii
蚸	lihmy
蛌	lihvo
蚴	livis
蚻	dulmi
蚼	lipr
蛘	litq
蛢	litt
蛦	likn
蛓	jilmi
蛣	ligr
蛚	limnn
蛪	qhlmi
蛝	liav
蛐	litw
蛞	lihjr
蛫	linmu
蛜	liosk
蛬	tclmi
蛩	mnlmi
蛗	hrlmi
蜋	liiav
蜄	limmv
蛷	liije
蜌	lippg
蛺	likoo
蛖	liiuh
蛵	limvm
蝍	liail
蛸	lifb
蜆	libuu
蜎	lirb
蜉	libnd
蜁	liono
蜊	lihdn
蛶	libdi
蜍	liomd
蜳	liyrd
蜷	lifqu
蜣	litgu
蜨	lijlo
蝫	lijka
蝀	lidw
蜮	liirm
蜞	litmc
蜡	lita
蜙	lidci
蜛	lisjr
蝃	lieee
蜬	liune
蝁	mmlmi
蜾	liwd
蝆	litq
蜠	liwhd
蜲	lihdv
蜩	libgr
蜪	lipou
蜭	linhx
蜼	liog
蜒	linkm
蜺	lihxu
蜱	lihwj
蜵	lilxl
蝂	lille
蜦	liomb
蜧	lihsk
蜸	selmi
蜤	dllmi
蜚	lylmi
蜰	bulmi
蜑	nmlmi
蝖	lijmm
蝣	liysd
蝤	litcw
蝷	liitu
蟡	liikf
蝳	liqmy
蝘	lisav
蝔	lippa
蝛	liihv
蝒	limwl
蝡	limbk
蝚	linhd
蝑	linob
蝞	liahu
蝭	liamo
蝪	liamh
蝐	liabu
蝎	liapv
蝟	liwb
蝝	livno
蝯	libme
蝬	liuce
蝓	liomn
蝺	lihlb
蝮	lioae
蝜	linbc
蝥	nklmi
螛	lijqr
螏	likok
螗	liilr
螓	liqkd
螒	jjoli
螈	limhf
螁	liyav
螖	libbb
螘	liumt
蝹	liwot
螇	libvk
螣	bfqi
螅	lihup
螐	lihrf
螑	lihuk
螝	lihui
螄	lihrb
螔	lihyu
螜	gelmi
螚	iplmi
螾	lijmc
螪	liycb
螭	liyub
蟅	liitf
螰	liixp
螬	litwa
螹	lijjl
螵	limwf
螼	litlm
螮	likpb
蟉	lismh
蟃	liawe
蟂	lihad
蟌	lihwp
螷	ihji
螯	gklmi
蟄	gilmi
蟊	nhlii
螴	nwlmi
螶	sslii
螿	vilmi
螸	colmi
螽	hylii
蟞	fklmi
蟧	liffs
蟦	lijtc
蟢	ligrr
蟛	ligth
蟫	limwj
蟪	lijip
蟥	litlc
蟟	likcf
蟳	lismi
蟤	liruc
蟔	liwgf
蟠	lihdw
蟜	lihkb
蟓	linao
蟭	liogf
蟘	liopc
蟣	livii
螤	yilwo
蟗	jbuui
蟙	liyia
蠁	vllmi
蟴	tllmi
蟨	molmi
蠀	liioc
蟺	liywm
蠃	ynlmi
蟶	lisrg
蟷	lifbw
蠉	liwlv
蠌	liwlj
蠋	liwli
蟾	lincr
蠆	twbi
蟼	tklmi
蠈	bjlmi
蟿	jelmi
蠙	lijmc
蠐	liyx
蠑	liffd
蠗	lismg
蠓	litbo
蠖	litoe
蠩	liyra
蠝	liwww
蠛	litwi
蠠	mwlii
蠤	twlii
蠜	ddkli
蠫	bnlii
蠬	liybp
蠨	litlx
蠦	liypt
蠪	yplmi
蠥	ujlmi
蠰	liyrv
蠲	ttwli
蠮	lisem
蠳	libcv
蠸	litrg
蠷	libug
蠵	liuob
蠼	libue
蠾	lisei
蠽	filii
蠿	vmlii
衁	yvhbt
衃	htmf
衄	htng
衈	htsj
衊	httwi
衋	lqmat
衎	homjn
衒	hoyin
衖	hotcn
衕	hobrn
衚	hojrn
衧	lmd
衪	lpd
衩	lei
衭	lqo
衽	lhg
衵	la
衶	ll
衲	lob
袀	lpmm
衱	lnhe
衹	lhvp
衿	loin
衯	lcsh
袃	phyhv
衾	oinv
袉	ljp
袕	ljc
袨	lyvi
袢	lfq
袪	lgi
袚	likk
袑	lshr
袡	lgb
袟	lhqo
袘	lopd
袧	lpr
袙	lha
袛	lhpm
袗	lohh
袤	ynhv
袬	yirv
袌	ypuv
袺	lgr
裗	lyiu
袹	lma
袸	lkld
裀	lwk
袾	lhjd
袶	lheq
袼	lher
袷	lomr
袽	lvr
袲	yniv
裖	lmmv
裋	lmrt
裍	lwd
裎	lrhg
裞	lcru
裛	yrav
裒	yhxv
裚	qlyhv
裷	lfqu
裧	lff
裱	lqmv
裲	lmlb
裺	lklu
裾	lsjr
裮	laa
裼	laph
裶	llmy
裯	lbgr
裻	yeyhv
褁	wdhv
褅	lybb
褌	lbjj
褔	lmrw
褋	lptd
褗	lsav
褘	ldmq
褙	llpb
褆	lamo
褖	lvno
褑	lbme
褕	lomn
褊	lhsb
褎	yhdv
褡	ltor
褞	lwot
褦	libp
褰	jtcv
褭	ysfv
褮	ffbyv
褧	sfyhv
褱	ywlv
褢	yhiv
褩	heyhv
褵	lyub
褳	lyjj
褼	lmwu
褾	lmwf
襁	lnii
襒	lfbk
褷	lhoo
襂	liih
褽	siyhv
襓	lggu
襋	ldbb
襏	lnoe
襌	lrrj
襆	ltco
襐	lnao
襢	lywm
襚	lyto
襛	ltwv
襗	lwlj
襡	lwli
襜	lncr
襘	loma
襝	lomo
襞	sjyhv
襣	lhul
襦	lmbb
襭	lgrc
襩	lgwc
襮	late
襬	lwlp
襶	ljic
襴	lanw
襳	loim
襹	lmmp
襺	ltbi
襾	mub
覂	mwhio
覅	mvphh
覈	mwhsk
覕	phbuu
覘	yrbuu
覜	lmuou
覛	hvbuu
覝	mfbuu
覡	mobuu
覢	ffbuu
覤	yubuu
覣	hvbuu
覭	bcbuu
覯	tbbuu
覮	ffbbu
覷	ymbuu
覶	bbbuu
覿	gcbuu
觔	nbks
觓	nbvl
觖	nbdk
觙	nbnhe
觕	hqnbg
觝	nbhpm
觚	nbhvo
觟	nbgg
觥	nbfmu
觤	nbnmu
觡	nbher
觠	fqnbg
觢	qhnbg
觜	ypnbg
觩	nbije
觫	nbdl
觭	nbkmr
觰	nbjka
觬	nbhxu
觱	irnbg
觲	nbtgq
觳	gbhne
觶	nbrrj
觷	hbnbg
觺	ponbg
觻	nbvid
觼	nbnbe
觾	nbtlf
觿	nbuob
訄	knymr
訇	pymr
訏	yrmd
訒	yrshi
訑	yrpd
訰	yrpu
訧	yriku
訬	yrfh
訞	yrhk
訢	yrhml
詎	yrss
詍	yrpt
訶	yrmnr
訹	yrijc
詙	yrikk
詖	yrdhe
詀	yryr
詗	yrbr
詘	yruu
詄	yrhqo
詅	yroii
詒	yrir
詈	wlymr
詶	yrill
誆	yrsmg
詿	yrgg
詡	yrsmm
訿	yrymp
詷	yrbmr
誂	yrlmo
誄	yrqd
詵	yrhgu
詻	yrher
誃	yrnin
訾	ypymr
誫	yrmmv
誙	yrmvm
誋	yrsup
誚	yrfb
誒	yriok
誶	yryoj
諏	yrsje
諆	yrtmc
誸	yrnyi
諓	yrii
諑	yrmso
諔	yryfe
諕	yrypu
誻	yrea
誹	yrlmy
諗	yroip
誾	anymr
諛	yrhxo
諀	yrhwj
諅	tcymr
諠	yrjmm
諳	yryta
諢	yrbjj
諲	yrmwg
諶	yrtmv
諴	yrihr
諵	yrjbj
諝	yrnob
謔	yrypm
諤	yrrrs
諟	yramo
諰	yrwp
諼	yrbme
諈	yrhjm
諞	yrhsb
諡	yrcmt
謞	yryrb
謐	yrpht
謘	yrsyj
謖	yrwce
謑	yrbvk
謅	yrpuu
謋	yrnqd
謏	yrhxe
謒	yroir
謕	yrhyu
謇	jtcr
謍	ffbyr
謈	atcr
謫	yrycb
謪	yrycb
謧	yryub
謣	yrmbs
謳	yrsrr
謰	yryjj
謵	yrsma
譇	yrkja
謯	yrypm
謼	yrypd
謾	yrawe
謱	yrllv
謥	yrhwp
謷	gkymr
謦	geymr
譐	yrtwi
譈	yrydk
譊	yrggu
譆	yrgrr
譀	yrmjk
譓	yrjip
譖	yrmua
譔	yrruc
譋	yranb
譕	yrotf
譑	yrhkb
譙	yrogf
譠	yrywm
譪	yrtav
譝	yrrxu
譨	yrtwv
譟	yrrrd
譣	yromo
譥	hkymr
譹	yryro
譸	yrgni
譅	yrsim
譺	yrpko
譻	bcymr
譾	yrtbm
讄	yrwww
讂	yrnbe
讆	hnymr
讌	yrtlf
讎	ogyrg
讋	ypymr
讔	yrnlp
讕	yranw
讘	yrsjj
讙	yrtrg
讜	yrfbf
讞	yrybk
讟	yrgcr
谹	crki
谻	crnq
谼	crtc
谽	croir
谾	crjcm
豃	crmjk
豇	mtm
豋	bomrt
豍	mthwj
豏	mttxc
豗	mumso
豜	momt
豝	moau
豟	mohsn
豥	moyvo
豤	moav
豦	ypmso
豨	mokkb
豭	morse
豰	gohne
豲	momhf
豳	umoo
豱	mowot
豯	mobvk
豵	mohoo
豷	mogbt
豶	mojtc
豸	bshh
豻	bhmj
豽	bhob
貁	bhjc
貀	bhuu
貆	bhmam
貄	bhlq
貅	bhod
貏	bhhwj
貑	bhrse
貒	bhumb
貕	bhbvk
貔	bhhwp
貙	bhsrr
貘	bhtak
貗	bhllv
貜	bhbue
貤	bcpd
貣	ipbuc
貺	bcrhu
貾	bchpm
貰	ptbuc
賌	yvoc
賕	bcije
賥	bcyoj
賟	bctbc
賙	bcbgr
賨	jmmc
賡	iloc
賚	dobuc
賵	bcabu
賮	lmfbc
賸	bfqc
賻	bcibi
賾	slqmc
贄	gibuc
贆	bcikk
贇	ymbuc
贐	bclmt
贔	bcbcc
贕	hhslc
贙	yubuc
赨	gclmi
赩	gcnau
赬	gcybc
赮	gcrse
赶	gomj
赸	gou
趄	gobm
趀	golxh
趑	gommo
趌	gogr
趎	gohjd
趏	gohjr
趍	gonin
趓	gonsd
趠	goyaj
趜	gopfd
趡	goog
趥	gotcw
趧	goamo
趬	goggu
趪	gotlc
趭	googf
趫	gohkb
趮	gorrd
趯	gosmg
趲	gohuc
趵	rmpm
趷	rmon
趼	rmmjj
趺	rmqo
跂	rmje
趹	rmdk
趿	rmnhe
跘	rmfq
跓	rmyg
跍	rmjr
跇	rmpt
跖	rmmr
跜	rmsp
跏	rmksr
跕	rmyr
跙	rmbm
跈	rmohh
跗	rmodi
跅	rmhmy
跤	rmyck
跰	rmtt
跠	rmkn
跬	rmgg
跱	rmgdi
跮	rmmig
跐	rmymp
跩	rmlwp
跦	rmhjd
跣	rmhgu
跢	rmnin
跧	rmomg
跲	rmomr
跫	mnryo
踉	rmiav
踂	rmsju
跿	rmgyo
踍	rmjkd
跽	rmsup
踊	rmnib
踃	rmfb
踇	rmowy
踆	rmice
踅	qlryo
跾	okryo
踠	rmjnu
踣	rmytr
踥	rmytv
踤	rmyoj
踮	rmiyr
踡	rmfqu
踕	rmjlo
踛	rmgcg
踖	rmta
踑	rmtmc
踙	rmsje
踦	rmkmr
踞	rmsjr
踧	rmyfe
踔	rmyaj
踒	rmhdv
踘	rmpfd
踓	rmog
踳	rmqka
踾	rmmrw
踸	rmtmv
蹀	rmptd
蹅	rmdam
踶	rmamo
踼	rmamh
踽	rmhlb
蹁	rmhsb
踰	rmomn
蹎	rmjbc
蹍	rmstv
蹓	rmhhw
蹐	rmfcb
蹌	rmoir
蹇	jtco
蹜	rmjoa
蹢	rmycb
蹠	rmitf
蹗	rmixp
蹟	rmqmc
蹖	rmqkx
蹞	rmpmc
蹥	rmyjj
蹧	rmtwa
蹛	rmkpb
蹚	rmfbg
蹕	rmwtj
蹡	rmvmi
蹝	rmhoo
蹩	fkryo
蹔	jlryo
蹴	rmyfu
蹭	rmcwa
蹸	rmfdq
蹳	rmnoe
蹪	rmlmc
蹯	rmhdw
蹻	rmhkb
躆	rmypo
躈	rmhsk
躄	sjryo
躋	rmyx
躕	rmigi
躔	rmiwg
躚	rmymu
躒	rmvid
躓	rmhlc
躐	rmvvv
躖	rmvim
躗	hnryo
躞	rmffe
躟	rmyrv
躠	tjryo
躥	rmjcv
躤	rmtqa
躣	rmbug
躦	rmhuc
躩	rmbue
躨	rmtce
躽	hhsav
軏	jjmu
軑	jjk
軓	jjhni
軘	jjpu
軞	jjhqu
軝	jjhvp
軯	jjmfj
軷	jjikk
軺	jjshr
軹	jjrc
軦	jjrhu
軮	jjlbk
軥	jjpr
軵	jjodi
軧	jjhpm
軨	jjoii
軶	jjhsn
軫	jjohh
軱	jjhvo
軬	ikjwj
輆	jjyvo
軿	jjtt
輁	jjtc
輀	jjmbl
輅	jjher
輇	jjomg
輈	jjhby
輂	tcjwj
輋	ukjj
輐	jjjmu
輑	jjskr
輬	jjyrf
輤	jjqmb
輘	jjgce
輚	jjii
輞	jjbtv
輠	jjwd
輥	jjapp
輣	jjbb
輖	jjbgr
輗	jjhxu
輶	jjtcw
輳	jjqkk
輮	jjnhd
輵	jjapv
輲	jjumb
輹	jjoae
輷	jjpyr
輴	jjhju
轃	jjqkd
轀	jjwot
轆	jjixp
轇	jjsmh
轈	jjvvd
轒	jjjtc
轑	jjkcf
轏	jjsnd
轐	jjtco
轓	jjhdw
轙	jjtgi
轖	jjgow
轗	jjirp
轕	jjtav
轘	jjwlv
轚	jejwj
轞	jjsmt
轛	jjtgi
轝	hcjwj
轠	jjwww
轢	jjvid
轤	jjypt
辴	rjmmv
迉	ys
迒	yyhn
迋	ymg
迓	ymvh
迍	ypu
迖	yik
迕	yoj
迣	ypt
迡	ysp
迤	yopd
迮	yos
迨	yir
迸	ytt
迾	ymnn
迵	ybmr
适	yhjr
迿	ypa
迻	ynin
逄	yheq
逤	yefh
逋	yijb
逑	yije
逜	ymmr
逌	yyws
逡	yice
逭	yjrr
逴	yyaj
逯	yvne
逶	yhdv
遒	ytcw
逿	yamh
遄	yumb
遢	yasm
遝	ywle
遛	yhhw
遳	ytog
遰	ykpb
遯	ybmo
遶	yggu
遹	ynhb
遻	yrru
邆	ynot
邅	yywm
遾	yhmo
邃	yjco
邈	ybhu
邋	yvvv
邍	yhwe
邙	yvnl
邗	mjnl
邘	mdnl
邛	mnl
邔	sunl
邟	ynnl
邡	ysnl
邥	lunl
邞	qonl
邧	munl
邠	chnl
邲	phnl
邴	mbnl
邶	lmpnl
邯	tmnl
邳	mmnl
邰	irnl
郱	ttnl
邽	ggnl
邿	ginl
郕	isnl
郅	mgnl
邾	hdnl
郇	panl
郋	hunl
郃	ornl
郈	hrnl
郖	mtnl
郠	mknl
郙	ibnl
郚	mrnl
郣	jdnl
郝	gcnl
郟	konl
郥	bcnl
郢	rgnl
郘	rrnl
郛	bdnl
郗	kbnl
郜	hrnl
郤	crnl
郯	ffnl
郪	jvnl
郰	sjenl
郴	ddnl
郲	donl
郳	hunl
郔	nmnl
郫	hjnl
鄆	bjnl
鄬	ifnl
鄄	mgnl
郾	svnl
郿	aunl
郼	dqnl
鄈	nknl
郹	bknl
郻	bvnl
鄁	lbnl
鄀	trnl
鄇	onkl
鄅	hbnl
鄃	onnl
郺	nnvvu
鄗	ybnl
鄐	ywnl
鄍	bcnl
鄏	minl
鄑	manl
鄖	rcnl
鄔	hfnl
鄋	henl
鄎	hpnl
鄣	yjnl
鄘	ibnl
鄜	ipnl
鄠	msnl
鄢	mfnl
鄟	jinl
鄞	tmnl
鄝	shnl
鄚	tknl
鄤	aenl
鄡	hdnl
鄛	vdnl
鄨	fkrau
鄯	trnl
鄫	canl
鄩	sinl
鄪	lcnl
鄲	rjnl
鄦	ofnl
鄮	hcnl
鄳	runl
鄵	rdnl
鄴	tdnl
鄶	oanl
鄸	tnnl
鄺	icnl
鄻	qjnl
鄾	menl
酀	tfnl
酃	mrnl
酁	ninl
酆	utnl
酄	tgnl
酅	ubnl
酈	mpnl
酇	hcnl
酐	mwmj
酎	mwdi
酏	mwpd
酖	mwlbu
酘	mwhne
酚	mwcsh
酓	oinw
酡	mwjp
酤	mwjr
酟	mwyr
酢	mwos
酮	mwbmr
酯	mwpa
酺	mwijb
酲	mwrhg
酹	mwbdi
酴	mwomd
酳	mwvib
醅	mwytr
醆	mwii
醊	mweee
醁	mwvne
醓	mwlut
醐	mwjrb
醑	mwnob
醍	mwamo
醚	mwyfd
醢	mwkrt
醛	mwtog
醙	mwhxe
醟	ffbmw
醨	mwyub
醥	mwmwf
醧	mwsrr
醯	mwyit
醪	mwsmh
醰	mwmwj
醱	mwnoe
醭	mwtco
醮	mwogf
醷	mwytp
醵	mwypo
醴	mwtwt
醲	mwtwv
醳	mwwlj
醹	mwmbb
醼	mwtlf
醾	mwidd
醽	mwmbr
釂	mwbwi
釃	mwmmp
釅	mwrrk
釆	hfd
釔	cn
釕	cnn
釙	cy
釢	cnhs
釬	cmj
釭	cm
釴	cip
釱	ck
釳	con
釩	chni
釸	cni
釤	chhh
釹	cv
鈁	cyhs
鈊	cp
鈥	cf
鈇	cqo
鈃	cmt
鈚	cpp
鈦	cki
鈏	cnl
鈌	cdk
鈀	cau
鈒	cnhe
釿	chml
鈑	che
釽	chlo
鈆	cci
鉈	cjp
鉒	cyg
鈰	cylb
鉉	cyvi
鉍	cph
鈺	cmgi
鉦	cmym
鉅	css
鈳	cmnr
鉥	cijc
鉞	civ
銃	cyiu
鈮	csp
鉊	cshr
鈹	cdhe
鉆	cyr
鉭	cam
鉬	cbu
鉏	cbm
鈿	cw
鉠	clbk
鉧	cwyi
鉯	cvio
鉚	chhl
鈶	cir
銨	cjv
銥	cyhv
鉼	ctt
銤	cfd
鉶	cmtn
銛	chjr
鉺	csj
銠	cjkp
銔	cmfj
銪	ckb
銍	cmig
銦	cwk
銚	clmo
銑	chgu
銫	cnau
鉹	cnin
銗	chmr
鉿	comr
銣	cvr
鋮	cihs
銎	mnc
鋐	cjki
鋃	ciav
鋄	cmfe
鋀	cmrt
鋙	cmmr
銶	cije
鋏	ckoo
鋱	cipp
鋟	csme
鋘	crvk
鋩	ctyv
鋇	cbuc
鋰	cwg
銲	camj
鋗	crb
鋝	cbdi
鋌	cnkg
鋯	chgr
鋂	cowy
鋨	chqi
鋊	ccor
鋈	ekc
錧	cjrr
錞	cyrd
錈	cfqu
錟	cff
錆	cqmb
錏	cmlm
鍺	cjka
錡	ckmr
錸	cdoo
錼	ckmf
錛	ckjt
錣	ceee
錒	cnlr
錕	capp
錮	cwjr
錁	cwd
鍆	can
錭	cbgr
錎	cnhx
錍	chwj
鋋	cnkm
錙	cvvw
鎡	ctvi
鎃	cehv
鎯	ciil
鍤	chjx
鍖	ctmv
鍇	cppa
鍼	cihr
鍘	cbcn
鍜	crse
鍶	cwp
鍉	camo
鍚	camh
鍔	crrs
鍐	cuce
鍑	coae
鍠	chag
鍭	conk
鎏	euc
鍌	euc
鍪	nkc
鎵	cjmo
鎬	cyrb
鎰	ctct
鎌	ctxc
鎒	cmvi
鎷	csqf
鎘	cmrb
鎛	cibi
鎝	ctor
鎉	casm
鎧	cumt
鎎	cond
鎪	chxe
鎚	cyhr
鎞	chwp
鎦	chhw
鎗	coir
鏞	cilb
鏇	cyso
鏏	cqjm
鏂	csrr
鏚	cihf
鏐	csmh
鏹	cnii
鏬	cypd
鏌	ctak
鏙	cuog
鎩	ckce
鏦	choo
鏊	gkc
鏨	jlc
鐋	ceah
鐓	cydk
鏻	cfdq
鐠	ctca
鐏	ctwi
鐔	cmwj
鏾	ctbk
鐕	cmua
鐐	ckcf
鐨	clnc
鐙	cnot
鐍	cnhb
鏵	ctmj
鐀	clmc
鏷	ctco
鐇	chdw
鐎	cogf
鐫	cogs
鐖	cvii
鐿	cytp
鐻	cypo
鐶	cwlv
鑌	cjmc
鑐	cmbb
鑊	ctoe
鑋	jmc
鑢	cypp
鑕	chlc
鑪	cypt
鑫	ccc
鑮	ctei
鑭	canw
鑯	coim
鑱	cnri
鑷	csjj
鑴	cuob
钂	cfbf
钀	cybk
钁	cbue
钃	csei
镺	sihk
镻	sihqo
镼	sisuu
镽	sikcf
閆	anmmm
閈	anmj
閍	anyhs
閌	anyhn
閎	anki
閟	anph
閜	anmnr
閞	anit
閬	aniav
閫	anwd
閼	anysy
闍	anjka
閾	anirm
閹	anklu
閺	anayk
閶	anaa
閿	anbbe
閵	anog
閽	anhpa
闇	anyta
闀	antcu
闉	anmwg
闃	anbuk
闅	anbue
閷	kcano
闕	antuo
闒	anasm
闓	anumt
闑	anhud
闚	anqou
闛	anfbg
闞	anmjk
闠	anlmc
闟	anorm
闥	anygq
闤	anwlv
阞	nlks
阢	nlmu
阤	nlpd
阠	nlnj
阬	nlyhn
阰	nlpp
阨	nlmsu
阯	nlylm
阹	nlgi
陂	nldhe
阽	nlyr
阼	nlos
阸	nlhsn
阺	nlhpm
陔	nlyvo
陏	nlkb
陑	nlmbl
陓	nlkms
陊	nlnin
陜	nlkoo
陘	nlmvm
陟	nlylh
陞	nlhtg
陬	nlsje
陼	nljka
陭	nlkmr
陫	nllmy
隇	nlihv
陾	nlmbk
隄	nlamo
隈	nlwmv
隉	nlhxg
隃	nlomn
隒	nltxc
隓	nlkmm
隑	nlumt
隗	nlhui
隞	nlgsk
隤	nllmc
隩	nlhbk
隮	nlyx
隰	nlavf
隳	nbop
隹	og
隼	ogj
隿	ipog
雂	onog
雈	tog
雎	bmog
雊	prog
雒	hrog
雓	odog
雔	ogog
雗	jjoog
雚	trrg
巂	uogb
雟	uogb
雘	bytoe
雝	vuog
雩	mbmms
雱	mbyhs
雰	mbcsh
雺	mbnih
雽	mbhfd
雿	mblmo
霅	mbymr
霈	mbejb
霂	mbed
霋	mbjlv
霒	mioin
霐	mbeni
霠	mbytn
霣	mbrbc
霢	mbbhv
霤	mbhhw
霩	mbydl
霫	mbsma
霬	mbwtc
霮	mbetv
霰	mbtbk
霵	mbrji
霿	mbnhu
靆	miyle
靃	mbogg
靉	mibbe
靚	qbbuu
靪	tjmn
靬	tjmj
靰	tjmu
靮	tjpm
靳	tjhml
靷	tjnl
靸	tjnhe
靲	tjoin
靽	tjfq
靺	tjdj
靾	tjpt
鞃	tjni
鞀	tjshr
鞂	tjhd
靻	tjbm
鞄	tjpru
鞊	tjgr
鞎	tjav
鞈	tjomr
鞙	tjrb
鞗	oloj
鞔	tjnau
鞚	tjjcm
鞡	tjqyt
鞜	tjea
鞞	tjhwj
鞬	tjnkq
鞮	tjamo
鞨	tjapv
鞫	tjpyr
鞤	gitlj
鞪	nktlj
鞳	tjtor
鞷	mrbj
鞶	hetlj
鞹	tjydl
鞻	tjllv
鞿	tjvii
韄	tjtoe
韅	tjavf
韇	tjgwc
韉	tjtif
韎	dqdj
韍	dqikk
韐	dqomr
韏	fqdmq
韕	dqyrd
韔	dqsmv
韗	dqbjj
韙	aodmq
韝	dqttb
韞	dqwot
韟	dqhaj
韡	dqtmj
韣	dqwli
韥	dqgwc
韰	yelsm
韱	oilsm
韹	yahag
韽	owyta
頄	knmbc
頇	mjmbc
頏	ynmbc
頍	jembc
頎	hlmbc
頖	fqmbc
頞	jvmbc
頝	ykmbc
頦	yombc
頩	ttmbc
頨	smmbc
頫	lmuoc
頠	numbc
頜	ormbc
頵	srmbc
頯	btmbc
頲	ngmbc
顁	jombc
顄	uembc
顊	hjmbc
顉	cmbc
顅	hbmbc
顐	bjmbc
顑	irmbc
顒	wbmbc
顜	tbmbc
顙	edmbc
顝	bbmbc
顗	utmbc
顠	mfmbc
顢	tbmbc
顣	ifmbc
顟	shmbc
顤	gumbc
顥	afmbc
顪	yhmbc
顩	oombc
顲	fwmbc
顳	sjmbc
顴	tgmbc
颬	hnmvh
颭	hnyr
颮	hnpru
颲	hnmnn
颸	hnwp
颿	sfhni
颽	uthni
颻	buhni
颾	hneii
飁	sahni
飂	hnsmh
飉	hnkcf
飆	ikhni
飋	hnmgh
飌	tghni
飣	oimn
飫	oihk
飶	oiph
餂	oihjr
餀	oitk
餈	mooiv
飺	ypoiv
餑	oijbd
餔	oiijb
餖	oimrt
餗	oidl
餕	oiice
餤	oiff
餟	oieee
餚	oikkb
餧	oihdv
餥	lyoiv
餫	oibjj
餬	oijrb
餪	oimbk
餳	oiamh
餲	oiapv
餯	oivno
餭	oihag
餱	oionk
餰	oihon
餮	mhoiv
饁	oigit
餼	oiond
饈	oitqg
饇	oisrr
饉	oitlm
饃	oitak
饐	oigbt
饎	oigrr
饙	oijtc
饌	oiruc
饋	oilmc
饗	vloiv
饘	oiywm
饔	yvgv
饕	ruoiv
饛	oitbo
饟	oiyrv
饡	oihuc
馗	knthu
馘	tuirm
馝	haph
馣	haklu
馦	hatxc
馯	sfmj
馲	sfhp
馰	sfpi
馵	sft
駃	sfdk
馹	sfa
馻	sfihu
馺	sfnhe
駂	pjsqf
馽	sfl
駜	sfph
駍	sfmfj
駏	sfss
駓	sfmfm
駔	sfbm
駎	sflw
駉	sfbr
駖	sfoii
駘	sfir
駮	sfyck
駬	sfsj
駥	sfij
駤	sfmig
駰	sfwk
駣	sflmo
駪	sfhgu
駩	sfomg
騂	sfytj
駺	sfiav
駴	sfit
駷	sfdl
駹	sfiuh
駸	sfsme
駶	sfssr
駻	sfamj
駽	sfrb
駾	sfcru
駼	sfomd
騃	sfiok
騏	sftmc
騋	sfdoo
騉	sfapp
騍	sfwd
騄	sfvne
騑	sflmy
騊	sfpou
騅	sfog
騇	sfomr
騚	sftbn
騕	sfmwv
騥	sfnhd
騝	sfnkq
騤	sfnok
騛	sfnoo
騢	sfrse
騠	sfamo
騧	sfbbr
騣	sfuce
騞	sfqjr
騜	sfhag
騵	sfmhf
騲	sftaj
騴	sfajv
騱	sfbvk
騬	sfhdp
騪	sfhxe
騶	sfpuu
騩	sfhui
騮	sfhhw
騸	sfhsm
騭	nhsqf
騹	sftlm
騽	sfsma
驆	sfwtj
驄	sfhwp
驂	sfiih
驁	gksqf
騺	gisqf
驎	sffdq
驓	sfcwa
驍	sfggu
驔	sfmwj
驌	sflx
驏	sfsnd
驈	sfnhb
驊	sftmj
驉	sfypm
驒	sfrrj
驖	sfjig
驞	sfjmc
驠	sftlf
驤	sfyrv
驦	sfmbu
驩	sftrg
驨	sfuob
驫	sfsff
骭	bbmj
骫	bbkni
骹	bbyck
骿	bbtt
骴	bbymp
骾	bbmlk
髁	bbwd
髀	bbhwj
髂	bbjhr
髇	bbyrb
髊	bbtqm
髆	bbibi
髍	bbijc
髐	bbggu
髑	bbwli
髕	bbjmc
髖	bbjti
髟	sihhh
髡	shmu
髣	shyhs
髧	shlbu
髬	shmfm
髫	shshr
髳	shnih
髲	shdhe
髶	shsj
髺	shhjr
髹	shod
髾	shfb
髽	shoog
鬁	shhdn
髼	shhej
鬈	shfqu
鬄	shaph
鬅	shbb
鬋	shtbn
鬊	shqka
鬎	shdbn
鬎	shdln
鬌	shkmb
鬐	shjpa
鬒	shjbc
鬕	shtak
鬗	shtlb
鬘	shawe
鬖	shiih
鬙	shcwa
鬞	shtwv
鬟	shwlv
鬠	shoma
鬣	shvvv
鬤	shyrv
鬩	lnhxu
鬫	lnmjk
鬮	lnnxu
鬯	uip
鬳	ypmrb
鬵	mumrb
鬷	mbuce
鬺	mboah
鬻	nnmrb
鬾	hije
鬿	hihml
魆	hiiv
魃	hiikk
魈	hifb
魊	hiirm
魎	himlb
魌	hitmc
魍	hibtv
魋	hiog
魑	hiyub
魖	hiypm
魠	nfhp
魡	nfpi
魧	nfyhn
魴	nfyhs
魱	nfmvm
魦	nffh
魶	nfob
魵	nfcsh
鮀	nfjp
鮅	nfph
鮇	nfjd
魼	nfgi
魾	nfmfm
魻	nfwl
鮂	nfwo
鮓	nfos
鮒	nfodi
鮐	nfir
鮚	nfgr
鮭	nfgg
鮨	nfpa
鮞	nfmbl
鮛	nfymf
鮦	nfbmr
鮡	nflmo
鮥	nfher
鮤	mnnwf
鮆	ypnwf
鯇	nfjmu
鯆	nfijb
鯃	nfmmr
鮿	nfsju
鯁	nfmlk
鮵	nfcru
鮸	nfnau
鯈	olof
鯓	nfhxh
鯀	nfhvf
鯖	nfqmb
鯪	nfgce
鯫	nfsje
鯠	nfdoo
鯞	nfsmb
鯤	nfapp
鯛	nfbgr
鯦	nfhor
鯢	nfhxu
鯰	nfoip
鯔	nfvvw
鯗	tonwf
鯬	hhnwf
鰌	nftcw
鰋	nfsav
鰈	nfptd
鯷	nfamo
鰅	nfwlb
鰒	nfoae
鯸	nfonk
鱀	aunwf
鰫	nfjcr
鰝	nfyrb
鰜	nftxc
鰬	nfypk
鰣	nfagi
鰨	nfasm
鰩	nfbou
鱆	nfytj
鱈	nfmbm
鰿	nfqmc
鱄	nfjii
鰹	nfseg
鰳	nftjs
鱁	nfymo
鰼	nfsma
鰷	nfold
鰴	houfk
鰲	gknwf
鱒	nftwi
鱘	nfsmi
鱐	nflx
鱊	nfnhb
鱍	nfnoe
鱋	nfypm
鱕	nfhdw
鱣	nfywm
鱧	nftwt
鱦	nfrxu
鱢	nfrrd
鱞	nfwlv
鱠	nfoma
鱟	hbnwf
鱨	nffba
鱮	nfhxc
鱴	nftwi
鱳	nfvid
鱹	nftrg
鱺	nfmmp
鳦	hfn
鳪	yhaf
鳭	shhaf
鳧	hfhn
鳱	mjhaf
鳲	shaf
鳵	njhaf
鳼	ykhaf
鳺	qohaf
鳽	mthaf
鳿	mghaf
鳷	jehaf
鴇	pjhaf
鴀	mfhaf
鳹	onhaf
鳻	chhaf
鴈	mohf
鴅	byhaf
鴃	hfdk
鴥	hfjc
鴗	ythaf
鴠	amhaf
鴞	rshaf
鴔	hohaf
鴩	hohaf
鴝	prhaf
鴘	ithaf
鴢	viksf
鴐	krhaf
鴳	jvhaf
鵁	ykhaf
鵧	tthaf
鴶	grhaf
鴮	kshaf
鴯	mbhaf
鴱	tkhaf
鴸	hdhaf
鴰	hrhaf
鵅	hrhaf
鵂	odhf
鵃	hyhaf
鴾	iqhaf
鴷	mnhaf
鵀	oghaf
鴽	vrhaf
鵜	chhaf
鵓	jdhaf
鵏	ibhaf
鵊	kohaf
鵛	mmhaf
鵋	sphaf
鵙	bchaf
鵖	hphaf
鵌	hfomd
鵗	kbhaf
鵒	crhaf
鵔	hfice
鵟	kghaf
鵷	juhaf
鶁	yfhaf
鶊	iohaf
鶄	qbhaf
鶈	jvhaf
鵱	gghaf
鶀	hftmc
鵸	krhaf
鶆	dohaf
鶋	srhaf
鶌	suhaf
鵽	eeeef
鵫	yjhaf
鵴	pdhaf
鵵	nihaf
鵰	brhaf
鵩	bsef
鶅	vwhaf
鵳	hbhaf
鵻	hfog
鶂	huhaf
鵯	hjhaf
鵹	hhhaf
鶟	jkhaf
鶙	ybhaf
鶤	bjhaf
鶝	mwhaf
鶒	dlksf
鶘	jrbhf
鶐	ychaf
鶛	pahaf
鶠	svhaf
鶔	ndhaf
鶜	thhaf
鶪	bkhaf
鶗	aohaf
鶡	avhaf
鶚	rshaf
鶢	behaf
鶨	vohaf
鶞	huhaf
鶣	hbhaf
鶿	tvif
鶩	nkhaf
鶖	hfhaf
鶷	jrhaf
鶶	irhaf
鶼	tchaf
鷁	tthaf
鷇	gfhne
鷊	mbhaf
鷏	jchaf
鶾	jjohf
鷅	mdhaf
鷃	avhaf
鶻	bbhaf
鶵	puhaf
鷎	hmhaf
鷎	hjhaf
鶹	hwhaf
鶺	fbhaf
鶬	orhaf
鷈	hfhyu
鶱	jtcf
鶭	vshaf
鷛	ibhaf
鷒	jihaf
鷞	kkhaf
鷚	shhaf
鷋	tdhaf
鷐	avhaf
鷜	lvhaf
鷑	hthaf
鷟	ykhaf
鷩	fkhaf
鷙	gihaf
鷘	dkhaf
鷖	sehaf
鷵	sahaf
鷕	rghaf
鷻	hfydk
鷷	tihaf
鷯	kfhaf
鷣	mjhaf
鷫	lxhaf
鷸	nbhaf
鷤	rjhaf
鷶	wchaf
鷡	ofhaf
鷮	hbhaf
鷦	ofhaf
鷲	yuhaf
鷰	tlpf
鷢	mohaf
鸂	ebkf
鷾	yphaf
鸇	ymhaf
鸃	hftgi
鸆	ykhaf
鸅	wjhaf
鸀	wihaf
鸁	ynhaf
鸉	dhhaf
鷿	sjhaf
鷽	hbhaf
鸄	hkhaf
鸋	jnhaf
鸍	mbhaf
鸐	sghaf
鸏	tohaf
鸒	hchaf
鸑	kkhaf
鸔	hfate
鸓	wwhaf
鸕	ythaf
鸗	yphaf
鸙	obhaf
鸛	tghaf
鸝	mphaf
鹵	ywii
鹺	ywtqm
麀	ipp
麃	ipf
麈	ipyg
麆	ipbm
麇	iphd
麊	fdixp
麉	mjixp
麎	ipmmv
麌	iprvk
麔	iphor
麑	iphxu
麙	ipihr
麛	ipnsj
麚	iprse
麜	ipmwd
麠	ipmwm
麡	ipyx
麤	ipipp
麧	jeon
麮	jegi
麰	jeihq
麶	jeyub
麷	jeujt
黀	icsje
黂	icjtc
黈	tcyg
黌	hbtlc
黐	heyub
黓	wfip
黕	wflbu
黖	wfmvu
黚	wftm
黟	wfnin
黥	wfyrf
黤	wfklu
黧	hhwgf
黫	wfmwg
黮	wftmv
黭	wfort
黰	wfjbc
黲	wfiih
黳	sewgf
黵	wfncr
黶	mkwgf
黹	tcfb
黺	tbcsh
黻	tbikk
黼	tbijb
黽	rxu
黿	mmuu
鼁	girxu
鼀	gcrxu
鼆	bcrxu
鼉	rrwmu
鼊	sjrxu
鼏	bbul
鼐	nsbul
鼒	dhbul
鼖	jtge
鼛	gehor
鼘	gelxl
鼜	geeii
鼤	hvyk
鼣	hvik
鼢	hvcsh
鼥	hvikk
鼫	hvmr
鼪	hvhqm
鼩	hvpr
鼨	hvhey
鼭	hvgdi
鼯	hvmmr
鼰	hvbuc
鼮	hvnkg
鼱	hvqmb
鼵	hvjck
鼳	hvbuk
鼲	hvbjj
鼸	hvtxc
鼷	hvbvk
鼶	hvhyu
鼽	hlkn
齀	hlmvn
齁	hlpr
齂	hlle
齃	hlapv
齇	hlypm
齉	hljbv
齌	yxf
齍	yxbt
齎	yxbuc
齏	yxlsm
齔	yup
齕	yuon
齖	yumvh
齗	yuhml
齘	yuoll
齛	yupt
齠	yushr
齞	yurc
齝	yuir
齥	yulwp
齤	fqymu
齧	qhymu
齫	yuwd
齱	yusje
齰	yuta
齮	yukmr
齯	yuhxu
齴	yuyhh
齵	yuwlb
齶	yurrs
齸	yutct
齻	yujbc
齺	yupuu
齹	tmymu
齾	ykymu
龒	ypmmf
龕	orybp
龠	omrb
龢	obhd
龤	obppa
